index,article,tags,rating,input_tokens,output_tokens,total_tokens,url
1,"6月17日，我国在酒泉卫星发射中心成功组织实施梦舟载人飞船零高度逃逸飞行试验，标志着我国载人月球探测工程研制工作取得新的重要突破。（新华社发）
参考消息网6月19日报道 据法哈拉斯新闻网6月17日报道，中国正通过太空技术领域的重大进展推进其探月雄心。据中国载人航天工程办公室消息，中国17日成功组织实施梦舟载人飞船零高度逃逸飞行试验，这是其实现航天员登月目标的关键一步。
报道称，此次测试涉及飞船的逃逸塔系统，通过点燃固体火箭发动机使船塔组合体升空。最终，梦舟载人飞船安全返回地面，验证了其系统安全性。这是否意味着这一次中国将先于美国国家航空航天局(NASA)登月？
报道称，中国梦舟载人飞船零高度逃逸飞行试验的成功，标志着其月球探索进程中的一个关键节点，使其有望与NASA的阿耳忒弥斯登月计划展开竞争。
报道称，中国在月球技术领域的进步凸显了太空探索领域的竞争格局，中美两国正力争在未来任务中占据主导地位。
另据印度新闻9直播网站6月17日报道，中国成功进行梦舟载人飞船发射台中止试验。这是在酒泉卫星发射中心进行的零高度逃逸飞行试验。
报道称，这是继1998年神舟载人飞船零高度逃逸飞行试验之后，时隔27年中国再度组织实施这项试验。神舟飞船用于中国空间站乘组人员轮换。
经过重新设计的梦舟载人飞船逃逸发动机正常运行，船塔组合体在固体发动机推进下升空，返回舱与逃逸塔安全分离。在飞行两分钟后，返回舱使用气囊缓冲方式安全着陆于试验落区预定区域。
报道指出，这一安全机制对载人航天至关重要，因为一旦飞行过程中发生故障，它可以使乘员迅速远离危险并安全返回地面。
报道称，此次试验的成功为中国后续载人月球探测任务奠定了重要的技术基础。中国的载人月面着陆器被命名为“揽月”。
由于大气压力的变化，乘组人员的逃逸设备会根据不同的高度进行调整。乘组人员逃逸系统的火箭发动机位于飞船的顶部。梦舟载人飞船系统全面负责逃逸与救生两项任务。
报道称，中国一直在测试其地月空间运输体系各个组成部分，并加强了载人登月计划。（编译/邬眉、马丹）",科技 # 航天 # 探月工程 # 国际竞争,9,1290,17,1307,https://www.cankaoxiaoxi.com/#/detailsPage/tt/8c93bff81ae94492af5dcc7548862be5/1/2025-06-19%2014:12?childrenAlias=undefined
2,"参考消息网6月19日报道 据俄新社6月17日报道，莫斯科旅游委员会主席叶夫根尼·科兹洛夫表示，中国人在莫斯科旅游的日均消费在所有外国游客群体中位居第一，人均单日支出约4.4万卢布(1卢布约合0.09元人民币——本网注)。
科兹洛夫说：“外国游客对城市经济很重要，外国游客人均在莫斯科消费超过20万卢布。而中国人在莫斯科旅游的日均消费位居第一，约为4.4万卢布。”
另据塔斯社6月17日报道，莫斯科旅游委员会主席科兹洛夫说，“莫斯科文化节”6月12日至15日在北京举行，这是莫斯科在海外举办的最大规模文化推介项目。
科兹洛夫说：“莫斯科首次如此大规模地在海外展示自己，而北京是首个举办莫斯科主题文化节的城市。‘莫斯科文化节’举办了150多项活动，还包括丰富的商务项目，这有助于展现多元的莫斯科。与‘莫斯科中国春节文化节’一样，这是俄中友好的又一座桥梁。”
莫斯科旅游委员会发布消息称，6月12日至15日，在北京王府井步行街举办的“莫斯科文化节”吸引了超过280万人次参与。
莫斯科旅游委员会援引莫斯科副市长纳塔利娅·谢尔古宁娜的话说：“共285万人次参与此次文化节。他们聆听现代和古典音乐演出，参加舞蹈课堂，品尝俄罗斯美食，学习制作具有民族特色的玩具和纪念品。”（编译/黎然）
6月16日，人们在俄罗斯莫斯科马涅什广场参观。（新华社发）",#旅游 #国际 #文化,8,910,7,917,https://www.cankaoxiaoxi.com/#/detailsPage/tt/3e7fbba37f6344af912f886051a47038/1/2025-06-19%2013:00?childrenAlias=undefined
3,"参考消息网6月19日报道 据新西兰广播电台网站6月18日报道，新西兰总理克里斯托弗·拉克森18日早间抵达中国，开启他作为总理的首次访华之旅。分析人士说，此访旨在寻求巩固两国关系。
报道称，拉克森将在上海停留大约两天，推销新西兰商品，然后在北京停留一天，与中方举行高层会谈。
报道称，为了帮助他实现这些目标，拉克森带来了旅游部长路易丝·厄普斯顿、少数族裔社区事务部长马克·米切尔以及一个由官员和商界领袖组成的团队。
米切尔在出发前对代表团发表讲话时说，鉴于当前全球巨大的不确定性，本次中国之行非常重要。
厄普斯顿说，新西兰与中国有着“长期而深厚的关系”，但还有很多工作要做。“特别是从旅游和酒店业的角度看，我们有点落后——所以我们需要认真做一些繁重的工作，以确保我们能够重建这些非常深厚的关系，并且确保中国市场知道我们愿意开展业务。”
报道称，这个由28人组成的商业代表团由新西兰航空董事长特蕾丝·沃尔什率领。成员包括恒天然、佳沛、A2牛奶和银蕨农场等企业。同样值得注意的还有教育机构新西兰理工学院、惠灵顿维多利亚大学和UP教育集团，以及奥克兰和克赖斯特彻奇机场。
在启程前接受新西兰广播电台采访时，拉克森用了一系列形容词来描述两国关系：牢固、成熟、复杂、深思熟虑、可预测。
他说：“这是一种重要的关系。在这种关系中，我们还有很多需要建设和发展的东西。”
坎特伯雷大学政治学教授安妮-玛丽·布雷迪告诉记者，拉克森将会利用此次访问强调积极的合作领域，以保护贸易关系。
另据新西兰《邮报》网站6月18日报道，中国官员和官方媒体对新西兰总理拉克森访华表示欢迎，拉克森此行旨在提振低迷的旅游和教育贸易。
报道称，拉克森此次上海之行的重点将是促进贸易发展，之后他将前往北京。
拉克森17日离开奥克兰前接受《邮报》采访时表示，他自上世纪90年代中期以来经常访问中国，“我亲眼目睹了中国的巨大变化”。
他说：“中国取得了令人难以置信的进步。我的意思是，我第一次去的时候，自行车比汽车多得多，而且由于车辆不多，高速公路上很空旷，而现在情况正好相反，对吧？”
拉克森说：“中国是有数千年历史的重要文明古国，它将在未来影响全球事务，无论是在技术贸易领域，还是在国防安全领域，中国都是一个非常重要的国家。”（编译/葛雪蕾、杨新鹏、张琳）
新西兰总理拉克森（美联社）",政治 # 国际 # 贸易,8,1394,11,1405,https://www.cankaoxiaoxi.com/#/detailsPage/tt/eb986fb8148c4d2b878de8738d2fe1e3/1/2025-06-19%2009:14?childrenAlias=undefined
4,"参考消息网6月19日报道 俄罗斯《消息报》网站6月17日刊登题为《中式外交》的文章，作者是达里娅·萨普伦斯卡娅。文章摘编如下：
近年来，中国成功重构了与中亚国家的合作方式：“C5+1”(中亚五国+中国)形式的部长级会议从2020年起开始举办。2023年中国和中亚国家在西安举行首届中国—中亚峰会并签署《西安宣言》后，中国国家主席习近平提出的人类命运共同体理念开始在中亚得到积极推行。第二届中国—中亚峰会17日在哈萨克斯坦举行，它是中亚国家与中国有关合作方向的对话的延续。
本届峰会和习近平主席此次哈萨克斯坦之行一样，都是在世界冲突激化和国际政治局势复杂化的背景下进行的。一些媒体称，中国希望建立一个在未来中美对抗中可以依靠的“忠诚联盟”。但中方始终坚持与中亚和平共处的理念，从峰会上讨论的内容看，核心议程也与此无关。
显然，习近平主席的访问侧重于该地区发展的几个关键要点——能源、运输走廊和数字化。当然，峰会期间签署的文件不会仅限于这三方面，因为与中国合作的机会正变得越来越多。例如，在哈萨克斯坦，不仅传统的中文学习中心纷纷涌现，还成立了不少研究中国现代化、科学和技术转让问题的专门分析机构。换句话说，中方正在各领域积极开展活动以加强协作，而且这些活动也相当富有成效。
对于中亚而言，与中国的经济协作拥有坚实基础。例如，哈萨克斯坦总统托卡耶夫称，“中国在讨论大型经济项目时从不附加政治条件”，而且能快速履行所有协议。对于该地区国家来说，这一论断十分重要，因为它们正在与中方实施众多经济项目。
回到经济问题上，能源对中国很重要。尽管世界经济出现了某种减速，但中国的实力并未减弱，因此市场需求没有下降。有消息称，哈萨克斯坦已与中国电力建设集团在第二届中国—中亚峰会期间签署了协议。
中国对中亚国家基础设施和物流潜力的建设已实施相当长时间。除了共建“一带一路”倡议框架内的项目外，中国还积极吸引中亚参与中巴经济走廊建设。这一战略中的关键项目包括已启动的中吉乌铁路和对跨阿富汗铁路的支持。
所有这些项目不仅能通过促进贸易交流来改变该地区状况，还将成为向世界传播中国理念的支持性力量。（编译/刘洋）",国际 # 政治 # 经济 # 一带一路,8,1290,13,1303,https://www.cankaoxiaoxi.com/#/detailsPage/tt/0d49808c0ebb4ea682a049170d47d680/1/2025-06-19%2009:14?childrenAlias=undefined
5,"参考消息网6月18日报道 美国《纽约时报》网站6月16日刊发题为《这个不是特别可爱的小精灵能让中国变酷吗？》的文章，文章编译如下：
在中国争取赢得全球民心的行动中，其最新武器是一个长着尖牙、兔子耳朵、丑萌丑萌的毛绒玩具。
这个咧着嘴笑的毛绒玩具名叫拉布布，由中国公司制造，已成为全球风潮。
最近几个月，它被美国歌星蕾哈娜和英国退役球星贝克汉姆等名人随身携带；在英国引发了抢购顾客之间的斗殴；在洛杉矶让人们通宵排队。一些狂热粉丝甚至特别为它安排了中国之行，希望能够买到它。
菲律宾博主利安娜·帕特里夏·吉勒莫在视频配文中写道：“我专程飞到中国，只为参观世界上最大的泡泡玛特商店。”泡泡玛特是拉布布的生产商。
人们对拉布布的热情可能像其他流行趋势一样转瞬即逝。但这可能也预示着中国在赢得海外文化影响力方面开始取得一些胜利。
其他获得全球关注的中国产品还包括《黑神话：悟空》这样的游戏；由比亚迪和其他品牌推出的价格实惠、制作精良的电动汽车；中国的人工智能模型DeepSeek已被包括美国和欧洲在内的海外科技公司采用；国外旅游博主纷纷上传自己滔滔不绝讲述上海天际线和成都大熊猫的视频等等。
更多的小众产品，如中国的古装剧等也在吸引海外观众。
中国在增强经济实力的同时，也一直在努力建设自身独具特色的软实力。
在中国国内，这一努力是成功的。许多中国人现在转向本土品牌和中国明星，而不是他们曾经崇拜的西方世界。
此外，有迹象表明，一些外国拉布布迷正在接触其他中国产品。
在美国的红迪网站上，用户们交流着通过全球速卖通等中国电商平台订购玩偶和服饰的经验技巧，并对美国针对中国商品加征关税表示担忧。
30岁的澳大利亚人休·阿夫去年专程赴上海寻找拉布布玩偶，她计划今年晚些时候再到中国旅行。除了探访其他中国城市外，她还打算多买些自己发现的中国品牌服饰。
她表示，她在澳大利亚的朋友们在目睹了拉布布引发的狂热后，“对中国的看法确实变得更加积极了”。
华侨大学研究中国对外传播的黄日涵教授说，中国企业全球影响力的持续扩大本身就是一种软实力的体现。
他指出，像泡泡玛特、腾讯和阿里巴巴这样的公司在全球各地的办公室雇用了不同国籍的员工。（编译/林朝晖）
5月6日，顾客在泰国曼谷的一家泡泡玛特商店中选购拉布布玩偶。（法新社）",社会 # 文化 # 国际 # 娱乐 # 经济,9,1399,18,1417,https://www.cankaoxiaoxi.com/#/detailsPage/tt/329d19f3dfae4b50b524f428cd62637c/1/2025-06-18%2009:46?childrenAlias=undefined
6,"参考消息网6月18日报道 据香港《南华早报》网站6月16日报道，根据美国摩根士丹利公司16日发布的一份研究报告，到2028年，中国机器人市场规模将从2024年的470亿美元增至1080亿美元，年增长率达到23%，这将进一步巩固中国在这一快速发展领域的主导地位。
报道称，这份由摩根士丹利分析师撰写的报告显示，中国去年在全球机器人市场的份额约为40%，但报告未对2028年中国市场份额作出预测。
作者指出：“中国不仅是最大的市场，更堪称世界创新中心，中国正在推动成本效益提升与下一代机器人技术的发展。”
报告说：“机器人持续重塑中国的制造业，未来随着机器人智能化、协作性和性价比的提升，它们还将对社会产生更深远的影响。”
中国国家统计局16日发布的一组数据显示，今年5月份，中国工业机器人产量同比增长35.5%，达到69056台；服务机器人产量增长13.8%，达到约121.6万台。
报道称，机器人技术是“中国制造2025”的重要内容。该计划于10年前启动，旨在推动中国跻身高科技产业前沿，成为全球智能制造领域领军者。
报道指出，中国已在全球机器人领域占据主导地位，去年工业机器人装机量占全球比重超过50%。中国目前拥有74.17万家机器人相关企业，包括优必选、宇树科技、智元等行业龙头。
摩根士丹利预测，无人机将成为中国机器人产业的最大细分领域，市场规模将从2024年的190亿美元增至2028年的400亿美元。
与此同时，中国的人形机器人市场也有望以63%的年增速快速扩张，规模将从今年的3亿美元增至2030年的34亿美元。
摩根士丹利的报告指出，到2030年，中国人形机器人数量将达到25.2万台，2050年预计将增至3.02亿台，占全球人形机器人存量的30%。报告说，今年将成为“人形机器人发展史上的里程碑之年，标志着人形机器人大规模量产的开端”。
报告还说，机器人技术正在持续重塑中国的制造业，除了推动生产力与品质提升，它们还将为未来产业升级奠定基础。（编译/王栋栋）
6月12日晚，机器人模特在天津时装秀上展示时装。（新华社）",科技 # 工业 # 制造业 # 人工智能 # 机器人,9,1270,17,1287,https://www.cankaoxiaoxi.com/#/detailsPage/tt/60d9242a59a1452aa232c042ba948143/1/2025-06-18%2009:42?childrenAlias=undefined
7,"参考消息网6月18日报道 据塔吉克斯坦阿维斯塔通讯社网站6月16日报道，首条连接塔吉克斯坦首都杜尚别与中国首都北京的直飞航线于16日正式开通。
报道称，航线开通仪式16日上午在北京大兴国际机场举行，这一事件开启了塔中两国运输和实业合作发展的重要阶段。
该航线的首飞航班由中国南方航空安排波音787机型飞机执飞。未来该航线计划采用波音737-8型飞机执飞，每周安排两班，时间分别为周二和周六。
塔吉克斯坦政府民航部门负责人哈比布洛·纳扎尔佐达称，这一航线的开通具有历史意义。他强调，这对进一步巩固塔中双边关系和发展两国航空运输十分重要。
纳扎尔佐达说：“这条航线不仅是旅客运输通道，也是我们两国间相互信任、扩大合作和文化交流的象征。”
中国南方航空副总经理曲光吉指出，新航线的开通将架起中国和塔吉克斯坦之间更加便捷的空中桥梁，有力促进双边经贸往来、人文交流和旅游合作，为两国关系发展和区域互联互通注入新的强劲动能。
报道称，首航航班机舱内部以中式风格装饰，搭配刺绣和灯笼等中国传统饰物。机上不仅提供美味餐食，还为旅客组织了有奖问答等娱乐活动。（编译/刘洋）
6月16日，CZ6051航班从北京大兴国际机场起飞。（新华社发）",国际 # 航空运输 # 中塔关系 # 文化交流,8,865,16,881,https://www.cankaoxiaoxi.com/#/detailsPage/tt/2a356f48d0c946e0821e4f475f72f459/1/2025-06-18%2009:33?childrenAlias=undefined
8,"第一关注
中国
国际
观点
锐参考
体育健康
科技应用
文化旅游
参考漫谈
参考智库
军事
民族品牌
参考人物
产经
地方
译名
文娱
我的位置：
首页
>
民族品牌
海尔连续22年跻身中国500最具价值品牌，蝉联前三
2025-06-18 15:52
新华每日电讯探厂实录：海尔合肥工厂解码 “中国质造” 品质内核
2025-06-17 16:46
共赴“青春之约”，吉大音乐节见证红旗品牌年轻化活力
2025-06-13 16:00
夏夜“绘”青春，红旗将携“年轻化家族”亮相吉林大学草地音乐节
新华财经
2025-06-09 11:40
海尔新能源推出行业领先的AI能源机器人，重构分布式新能源场景生态体系
2025-06-12 11:01
茅台亮相2025年日本大阪世博会
2025-06-06 16:39
以时代匠心铸就时代旗舰，尊界S800正式上市
2025-05-31 19:06
“蜀中桃子姐”：保持初心，做良心，做品质，将四川美食传递得更远｜2025世界品牌莫干山大会
2025-05-31 10:49
海尔新能源战略投资星能链公司，致力于以AI重塑分布式新能源行业
2025-05-30 14:17
海尔希望小学举办首届科技节，落成首个科技实验室
泰山财经
2025-05-29 16:57
跟着国家博物馆认识“115件文物里的古代中国”
2025-05-28 16:33
当奶酪""黏""上糯米：伊家好奶酪×五芳斋以""粽""情重构端午味觉记忆
半月谈网
2025-05-26 16:04
康师傅解码文化赋能新消费的美味路径
新华社客户端
2025-05-26 16:04
七度蝉联全球百强唯一物联网生态品牌，海尔品牌价值持续增长
2025-05-16 15:10
中国品牌正在成为新模式、新标准的创造者和引领者
新华社客户端
2025-05-14 18:58
从“一叶兴”到“百业旺” 安溪铁观音入选新华社品牌工程
2025-05-12 12:39
中国品牌 世界共享——与中国品牌日晚会共赴东方匠心之约
2025-05-12 11:54
茅台总经理王莉：以功能、体验、情绪三重价值回应消费者对品牌的新期待
2025-05-10 20:22
2025世界品牌莫干山大会“草坪故事会”在浙江德清举办
2025-05-10 20:22
科技创新擘画品牌进阶新图景——来自2025世界品牌莫干山大会的高端对话
2025-05-10 20:22
从本土突围到全球破圈 嘉宾建言消费品牌发展新路径
2025-05-10 18:54
厚植文化根脉 铸就品牌之魂——与会嘉宾畅谈文化与品牌
2025-05-10 18:54
奋斗者说，一座城市的青春叙事
2025-05-10 17:08
草坪故事会｜张旭：中国品牌是文化传承与世界对话的重要桥梁
2025-05-10 14:23
2025世界品牌莫干山大会｜品牌，让世界更美好
2025-05-10 09:01
草坪故事会｜张旭：中国品牌是文化传承与世界对话的重要桥梁
新华社客户端
2025-05-09 21:41
2025世界品牌莫干山大会｜记者探会：齐聚莫干山！聆听来自全球品牌的声音
新华社客户端
2025-05-09 18:35
倒计时1天，相聚莫干山！
2025-05-09 13:09
走笔莫干山
2025-05-09 09:59
品牌，让世界更美好
2025-05-09 09:57
再聚莫干山：解码品牌引领“中国制造”新征程
2025-05-09 09:55
服装品牌高质量发展论坛于5月11日在德清举办
2025-05-08 14:45
距2025世界品牌莫干山大会开幕还有1天
2025-05-08 08:50
2025世界品牌莫干山大会品牌展将在德清举办
2025-05-07 18:17
免费开放！科技潮玩、机器狗萌宠……品牌嘉年华预约开启
2025-05-07 18:17
距2025世界品牌莫干山大会开幕还有2天
2025-05-07 12:27
距2025世界品牌莫干山大会开幕还有3天
2025-05-06 11:21
洗净210种 海尔洗衣机创立行业污渍洁净新标准
新华社客户端
2025-05-06 11:20
“五一”国际劳动节丨致敬平凡 致敬劳动者
新华网
2025-05-01 15:36
京东宣布将推出2000亿出口转内销扶持计划
2025-04-11 21:31
周云杰：在变局中开新局
2025-04-11 16:38
中国科技力量精彩亮相世界移动通信大会
2025-03-06 09:40
救人！救火！海尔售后师傅化身救火尖兵
2025-03-02 10:49
中国银联大力推进“锦绣行动2025” 畅行锦绣中华 尽享支付无忧
2025-03-02 10:04
卡奥斯再下一城，海尔集团战略入股新时达
2025-02-17 14:52
科技改变生活！海尔国民AI电视帮银发族跨越“数字鸿沟”
2025-01-24 11:24
伊利：以人才发展为核心，培育新时代行业领军力量
2025-01-21 17:37
稳健双增长，创历史最好业绩！海尔2024全球营收超4000亿
2025-01-21 15:08
强烈推荐！看中国智能家电企业如何弥合“数字鸿沟”
2025-01-21 10:12
家属见证，菁英回家 中国乳都实力抢镜
2025-01-19 09:45
点击加载更多
排行榜
外媒分析：以色列为何此时对伊朗“动手”
美国：两场“大戏”即将同时上场！
外媒：伊朗和以色列军队孰强孰弱？
突发！以色列对伊朗发动打击
美媒：美政府取消四国数十万移民合法身份
美媒：中国赢得全球民心的“最新武器”
美媒：印航波音客机坠毁原因何在？
伊朗：“友好”国家已就以色列动武向德黑兰发出警报
西媒：论中国的长远思维与五年规划
针对以色列袭击伊朗，国际社会纷纷发声
站长统计",民族品牌 # 科技创新 # 中国品牌 # 海尔 # 茅台 # 智能家电 # 分布式新能源,8,4073,32,4105,https://www.cankaoxiaoxi.com/#/generalColumns/minzupp
9,"参考消息网6月19日报道 法国《回声报》网站6月16日刊登记者拉斐尔·巴莱涅里撰写的题为《在中国，治理长江污染是一项艰巨浩大的工程》的报道，编译如下：
这是一座依山而建的县城，长江游轮经过这里，在蜿蜒的江水上航行。在这个初夏的美好日子里，巫山码头的游轮载满游客。巫山县这座中国西南部的城镇就坐落在亚洲最长河流长江那壮观的峡谷中。
旁边，几艘颜色鲜亮、样式有些特别的蓝色小船也正等待解缆起航。
自2003年起，巫山便配备了一支由数十艘清漂作业船组成的船队。它们肩负的使命是清理长江，每天出发“捕捞”污染长江的垃圾，包括塑料、树枝、碎木片……每年5月至10月的汛期是最为棘手的阶段，季风带来的暴雨将周边城市和山上的各类垃圾冲入长江。
得益于船上安装的自动过滤系统，该清污工程每年可打捞处理2万余吨垃圾。巫山县为治理其管辖范围内55公里长的长江干流江段，每年投入上百万元人民币的专项资金。
在这项浩大工程启动20年后，巫山县开始收获治理成效。根据中国水质标准体系，长江巫山段干流断面水质已连续8年保持Ⅱ类标准、总磷浓度连续11年下降。
中国拥有1500多条流域面积超过1000平方公里的河流和七大水系。因此治理水污染问题对中国至关重要。据了解，长江流域拥有中国35%的水资源量。超过4亿中国人生活在长达6300公里的长江沿岸。
根据世界自然基金会的数据，长江流域还提供了全国一半以上的淡水鱼和三分之二的水稻产量。
过去40年，快速的城镇化进程和狂飙突进的经济发展等都给长江流域的自然生态系统造成了严重影响。
然而问题远不止于长江。根据2014年《自然》周刊发表的一篇文章，中国全国范围内的水污染每年导致大量水资源无法利用。
在此背景下，中国自新世纪以来不断加大长江治理力度。2002年，中国颁布《中华人民共和国水法》，标志着中国水治理的重要转折。随后在2015年，中国制定阶段性目标：到2020年七大重点流域水质优良(达到或优于Ⅲ类)比例总体达到70%以上，到2030年，全国七大重点流域水质优良比例总体达到75%以上。
为此，中国采取了一系列有力措施：关停沿江污染企业、淘汰老旧燃煤船舶、在全国范围内任命30万名地方官员担任“河长”……2021年，中国还实施了长江干流及主要支流为期十年的生产性捕捞禁令。
巫山县生态环境监测站站长魏嵬表示：“在巫山，长江沿岸5公里范围内禁止任何工业企业入驻。”在宜昌，曾经沿江而建的工厂也已被迁离，原址改建成了公园，如今市民们常在此遛狗、打太极拳。湖北省官员表示，截至2024年，该省已完成470多家沿江化工企业关改搬转工作，并腾退岸线近150公里。
重庆市生态环境局局长余国东表示：“长江干流禁捕后，监测到的鱼类品种增加了47种。”（编译/刘卓）
6月11日，轮船行驶在长江巫山段。（新华社）",环境 # 社会 # 科技,9,1735,10,1745,https://www.cankaoxiaoxi.com/#/detailsPage/zhongguo/34063682f51640c69fc9db0df6869b23/1/2025-06-19%2014:12?childrenAlias=undefined
10,"参考消息网6月19日报道 法国《回声报》网站6月16日刊登记者拉斐尔·巴莱涅里撰写的题为《在中国，治理长江污染是一项艰巨浩大的工程》的报道，编译如下：
这是一座依山而建的县城，长江游轮经过这里，在蜿蜒的江水上航行。在这个初夏的美好日子里，巫山码头的游轮载满游客。巫山县这座中国西南部的城镇就坐落在亚洲最长河流长江那壮观的峡谷中。
旁边，几艘颜色鲜亮、样式有些特别的蓝色小船也正等待解缆起航。
自2003年起，巫山便配备了一支由数十艘清漂作业船组成的船队。它们肩负的使命是清理长江，每天出发“捕捞”污染长江的垃圾，包括塑料、树枝、碎木片……每年5月至10月的汛期是最为棘手的阶段，季风带来的暴雨将周边城市和山上的各类垃圾冲入长江。
得益于船上安装的自动过滤系统，该清污工程每年可打捞处理2万余吨垃圾。巫山县为治理其管辖范围内55公里长的长江干流江段，每年投入上百万元人民币的专项资金。
在这项浩大工程启动20年后，巫山县开始收获治理成效。根据中国水质标准体系，长江巫山段干流断面水质已连续8年保持Ⅱ类标准、总磷浓度连续11年下降。
中国拥有1500多条流域面积超过1000平方公里的河流和七大水系。因此治理水污染问题对中国至关重要。据了解，长江流域拥有中国35%的水资源量。超过4亿中国人生活在长达6300公里的长江沿岸。
根据世界自然基金会的数据，长江流域还提供了全国一半以上的淡水鱼和三分之二的水稻产量。
过去40年，快速的城镇化进程和狂飙突进的经济发展等都给长江流域的自然生态系统造成了严重影响。
然而问题远不止于长江。根据2014年《自然》周刊发表的一篇文章，中国全国范围内的水污染每年导致大量水资源无法利用。
在此背景下，中国自新世纪以来不断加大长江治理力度。2002年，中国颁布《中华人民共和国水法》，标志着中国水治理的重要转折。随后在2015年，中国制定阶段性目标：到2020年七大重点流域水质优良(达到或优于Ⅲ类)比例总体达到70%以上，到2030年，全国七大重点流域水质优良比例总体达到75%以上。
为此，中国采取了一系列有力措施：关停沿江污染企业、淘汰老旧燃煤船舶、在全国范围内任命30万名地方官员担任“河长”……2021年，中国还实施了长江干流及主要支流为期十年的生产性捕捞禁令。
巫山县生态环境监测站站长魏嵬表示：“在巫山，长江沿岸5公里范围内禁止任何工业企业入驻。”在宜昌，曾经沿江而建的工厂也已被迁离，原址改建成了公园，如今市民们常在此遛狗、打太极拳。湖北省官员表示，截至2024年，该省已完成470多家沿江化工企业关改搬转工作，并腾退岸线近150公里。
重庆市生态环境局局长余国东表示：“长江干流禁捕后，监测到的鱼类品种增加了47种。”（编译/刘卓）
6月11日，轮船行驶在长江巫山段。（新华社）",环境 # 社会 # 科技,9,1735,10,1745,https://www.cankaoxiaoxi.com/#/detailsPage/zhongguo/34063682f51640c69fc9db0df6869b23/1/2025-06-19%2014:12?childrenAlias=undefined
11,"参考消息网6月19日报道 据台湾“中时新闻网”6月17日报道，岛内网红“馆长”陈之汉日前赴上海等地旅游，引发外界热议。有媒体对此发起网络投票，询问“馆长”此行是否有助促进两岸和平交流，结果显示，有近八成的参与者认为有帮助。
报道称，“馆长”日前赴陆观光，希望两岸多交流、多往来，并透过全程直播分享见闻，一度吸引超过40万名网友同时在线观看。台湾TVBS新闻网6月16日以“您认为‘馆长’陈之汉这次大陆行，对促进两岸和平交流有没有帮助”为题，发起网络投票。
本次投票将自6月16日统计至23日，截至17日晚间6点半，已有2200多人参与投票，其中79.4%的人认为有帮助(64%认为非常有帮助，15.4%认为还算有帮助)。
另据新加坡《联合早报》网站6月18日报道，“馆长”陈之汉的首次大陆行，在相当程度上为台湾基层掀开近在咫尺却又陌生的大陆面纱，也让两岸关系发生微妙转变。
报道称，陈之汉6月15日晚间结束六天五夜的上海和杭州行程返台。他在上海直播五天的视频，累计观看数超过1600万，最高同时在线人数更高达40余万，创下台湾YouTube直播史上最高纪录，碾压了政坛名人。
报道称，过去一周来，“馆长震撼”让蓝营评论人颇为振奋。知名政治评论员唐湘龙就点评，“两岸交流的‘防火墙’崩塌，民进党‘冷战的铁幕’瓦解了”。他认为，以“馆长”的能量，会对青年世代有深远影响，若其他网红跟进赴陆，对大陆整体发展环境有自然情感面的表达，民进党就会受重伤。
报道认为，“馆长震撼”之所以能产生，一个重要背景在于两岸探亲虽然开放了30多年，台湾2300万人中仍有超过1000万人从未去过大陆，其中很多人的“大陆观”仍停留在早年的反共宣传和民进党塑造的大陆负面形象。与一些蓝营政治人物相比，陈之汉没有政治包袱，又是第一次赴陆，他此次上海行打开了自己的眼界，也打破了一部分人的刻板印象。
对此，民进党和绿营政论节目群起而攻之，谴责陈之汉“贬低台湾”，讥笑他是“陈姥姥进大观园”，还有绿营名嘴要求将其“法办”。而陈之汉返回台湾后，也正式向民进党“开战”，宣布将全力协助在野的国民党和民众党力抗“大罢免”。
陈之汉强调，他无意贬低台湾，“不是台湾不好，而是民进党不好”，民进党正将台湾带往战争之路；他表示“我们都是同胞”，“自己人不打自己人”，他要为两岸和平作贡献，更希望台湾民众亲自走访大陆，用自己的眼睛去看大陆的真相。
报道称，陈之汉以普通民众的身份掀起大浪，让台湾人“看见”不同的大陆，这股能量估计还会继续搅动台湾政坛。",两岸交流 # 社会 # 政治,8,1638,11,1649,https://www.cankaoxiaoxi.com/#/detailsPage/zhongguo/ad9bd909bf1341e881451379637a9bd0/1/2025-06-19%2014:12?childrenAlias=undefined
12,"参考消息网6月19日报道 美国《福布斯》杂志网站6月16日刊发祖德·克莱门特撰写的文章，题为《中国对美国：人工智能霸权需要可靠的电力》，编译如下：
麦肯锡咨询公司所说的“人工智能(AI)竞争”可以归结为美国和中国在人工智能领域及其相关数据中心能力方面的霸主地位之争。按照通常的估计，在未来5到7年内，人工智能就将使美国的电力需求增加10%到20%。
虽然美国在人工智能和数据中心发展方面处于领先地位；但中国已经展示决心，出于经济、军事和国家安全原因要在这些新技术领域实现自立自强以扩大全球影响力。人工智能需要全天候供电，中国正在迅速制订计划以确保有可靠的电力来吸引并支持数据中心建设。但美国没有任何类型的持续连贯的能源计划。中国的中央规划为可持续发展创造条件，而美国对待能源的方式却每四年改变一次。在能源规划中，组织和远见至关重要。
中国重新致力于煤炭发电。2024年，中国新开工煤电项目的装机容量超过94吉瓦，为2015年以来最多的，这个数字也是美国现有煤电装机容量的一半以上。
需要强调两点：第一，中国煤电机组属于全世界最年轻、效率最高的机组之一，因此现有机组还能运行数十年；第二，中国的许多大型电厂都是超临界或超超临界设施，排放远低于标准煤电厂。中国在建设先进煤电厂方面处于领先地位。
与之形成鲜明对比的是，美国似乎有意从能源领域抹去煤电。自2010年以来，已有超过300家煤电厂关闭，煤炭发电量在全国供电中的占比从45%下降到今天的16%。最重要的是，美国能源信息局4月刚刚公布的《2025年能源展望》预测，从2025年到2035年，该国煤电装机容量将从164吉瓦骤降至仅3吉瓦。与此同步，煤炭发电量将在10年内下降93%。
别以为美国会依靠新的核电站满足数据中心的电力需求。《2025年能源展望》预测，核电装机容量和发电量到2040年都将下降。正如“为未来提供能量”组织的丹·特纳指出的，核管理委员会是官僚主义效率低下的典型案例。自1990年以来，只有5项申请获批，两座新核电站建成。
鉴于过去35年问题重重，未来20年很难看到核电对美国的供电作出重大贡献，除非过多的官僚主义障碍能迅速消除。与此同时，中国目前有58座运营的反应堆，总装机容量60吉瓦。目前还有约30座反应堆正在建设，总装机容量34吉瓦。说到赢得人工智能竞赛，中国可是认真的——中国运营了世界上第一个海底智能计算中心！
毫无疑问，特朗普在煤炭和核问题上都采取积极措施，但可持续性这个熟悉的问题依然存在。特朗普的任期在3年半以后就将结束。在那之后，美国是否会回到老样子？与此同时，中国的煤电厂则将为下一代数据中心提供电力。（编译/赵菲菲）
这是5月14日拍摄的“华龙一号”示范工程福清核电5、6号机组外景（无人机照片）（新华社发）",科技 # 能源 # 国际,9,1683,10,1693,https://www.cankaoxiaoxi.com/#/detailsPage/zhongguo/e87eb49645cf49a09ee01ff5053bd596/1/2025-06-19%2014:12?childrenAlias=undefined
13,"5月8日，顾客在泰国曼谷的一家泡泡玛特商店中选购拉布布玩偶。（法新社）
参考消息网6月19日报道 英国《金融时报》网站6月17日刊登题为《中国品牌扩展全球影响力》的报道，编译如下：
中国品牌正在重塑全球市场格局，并扩展它们在国际消费者群体中的影响力。
比亚迪电动汽车在欧洲的销量已经超越特斯拉，而在巴西销售的每10辆纯电动汽车中有7辆是由比亚迪制造的。已经把企业标识刻印在从行李箱到智能洗衣机的各类产品上的手机制造商小米，则把电动汽车加入其计划的出口产品列表中。而今年最抢手的玩偶拉布布则是由中国泡泡玛特公司推出的一款商品，该公司近40%的销售额来自海外市场。
根据专注于亚太品牌的多家品牌传播机构统计，过去18个月，寻求国际销售和进入新市场的中国企业数量显著增长。奥美公司亚太区首席执行官、WPP传播集团中国区总裁克里斯·赖特曼说：“在向中国以外市场寻求增长的企业的引领下，出现了一种相当显著的加速趋势。”
他补充说，通过电子商务转向中国以外市场使中国品牌无需支付巨额分销费用。中国企业更加重视数字技术，并且能够快速应用人工智能，这反映在它们对数字营销的投入上。他说：“短视频和脸书等平台对中国品牌出海起到了关键作用。”
日本电通集团中国首席转型与营销官钱忆琳称，中国企业的海外扩张已经使“中国式”的注重数字技术的品牌建设模式变得日益清晰。
去年夏季的巴黎奥运会和欧洲杯足球赛为中国企业提升全球知名度提供了宝贵机会。在乳品企业蒙牛和电商集团阿里巴巴已经拥有长期赞助协议的同时，新赞助商包括智能手机厂商vivo和车企比亚迪等。
喜茶和霸王茶姬等则开设了茶饮店以吸引奥运观众。2024年欧洲杯的13家全球官方赞助商中有5家是中国企业：比亚迪、蚂蚁集团、vivo、海信以及阿里巴巴旗下电商平台全球速卖通。
拥有20多年与中国企业合作经验的赖特曼称，像比亚迪等正在获得明显的全球认可和知名度的品牌也只是处在品牌建设的初级阶段。他说，比亚迪营销工作的重点是“告诉消费者该公司产品的具体特性”。
中国的全球关系成为影响中国品牌将以哪些市场作为拓展目标的一个因素。市场营销公司S4 Capital首席增长官兼执行总监斯科特·斯皮里特说：“它们倾向于进入摩擦较少、与中国关系友好的市场。”
这就是企业把出海重心转向中东、巴西及东南亚的原因。斯皮里特说：“义乌市场中的卖家现在都在学习阿拉伯语和西班牙语。”
去年，阿里巴巴集团增长最快的业务板块是国际电商，包括全球速卖通、来赞达（东南亚）、达拉兹（南亚）和特伦德约尔（土耳其）等平台。今年该集团正在转向人工智能和云服务，根据凯度咨询公司的品牌排名，阿里巴巴在中国品牌中排名第二，在全球品牌百强榜上名列第29。
在百强榜上排名最高的中国品牌是名列第11的腾讯。腾讯集团公共事务与全球政策主管丹尼·马蒂对于中国品牌的全球前景感到乐观。他说：“每个地方的消费者都希望获得优质的内容、出色的产品和满意的体验。亚洲拥有世界上最多的人口，数字时代从根本上改变了全球影响力格局。亚洲品牌在全球市场崭露头角并不令人意外。”（编译/曹卫国）",科技 # 财经 # 国际,8,1706,11,1717,https://www.cankaoxiaoxi.com/#/detailsPage/zhongguo/4c992b6fd778485aa90371650c68e35b/1/2025-06-19%2014:15?childrenAlias=undefined
14,"6月17日，我国在酒泉卫星发射中心成功组织实施梦舟载人飞船零高度逃逸飞行试验，标志着我国载人月球探测工程研制工作取得新的重要突破。（新华社发）
参考消息网6月19日报道 据法哈拉斯新闻网6月17日报道，中国正通过太空技术领域的重大进展推进其探月雄心。据中国载人航天工程办公室消息，中国17日成功组织实施梦舟载人飞船零高度逃逸飞行试验，这是其实现航天员登月目标的关键一步。
报道称，此次测试涉及飞船的逃逸塔系统，通过点燃固体火箭发动机使船塔组合体升空。最终，梦舟载人飞船安全返回地面，验证了其系统安全性。这是否意味着这一次中国将先于美国国家航空航天局(NASA)登月？
报道称，中国梦舟载人飞船零高度逃逸飞行试验的成功，标志着其月球探索进程中的一个关键节点，使其有望与NASA的阿耳忒弥斯登月计划展开竞争。
报道称，中国在月球技术领域的进步凸显了太空探索领域的竞争格局，中美两国正力争在未来任务中占据主导地位。
另据印度新闻9直播网站6月17日报道，中国成功进行梦舟载人飞船发射台中止试验。这是在酒泉卫星发射中心进行的零高度逃逸飞行试验。
报道称，这是继1998年神舟载人飞船零高度逃逸飞行试验之后，时隔27年中国再度组织实施这项试验。神舟飞船用于中国空间站乘组人员轮换。
经过重新设计的梦舟载人飞船逃逸发动机正常运行，船塔组合体在固体发动机推进下升空，返回舱与逃逸塔安全分离。在飞行两分钟后，返回舱使用气囊缓冲方式安全着陆于试验落区预定区域。
报道指出，这一安全机制对载人航天至关重要，因为一旦飞行过程中发生故障，它可以使乘员迅速远离危险并安全返回地面。
报道称，此次试验的成功为中国后续载人月球探测任务奠定了重要的技术基础。中国的载人月面着陆器被命名为“揽月”。
由于大气压力的变化，乘组人员的逃逸设备会根据不同的高度进行调整。乘组人员逃逸系统的火箭发动机位于飞船的顶部。梦舟载人飞船系统全面负责逃逸与救生两项任务。
报道称，中国一直在测试其地月空间运输体系各个组成部分，并加强了载人登月计划。（编译/邬眉、马丹）",科技 # 航天 # 探月工程 # 国际竞争,9,1290,17,1307,https://www.cankaoxiaoxi.com/#/detailsPage/zhongguo/8c93bff81ae94492af5dcc7548862be5/1/2025-06-19%2014:12?childrenAlias=undefined
15,"参考消息网6月19日报道 据俄新社6月17日报道，莫斯科旅游委员会主席叶夫根尼·科兹洛夫表示，中国人在莫斯科旅游的日均消费在所有外国游客群体中位居第一，人均单日支出约4.4万卢布(1卢布约合0.09元人民币——本网注)。
科兹洛夫说：“外国游客对城市经济很重要，外国游客人均在莫斯科消费超过20万卢布。而中国人在莫斯科旅游的日均消费位居第一，约为4.4万卢布。”
另据塔斯社6月17日报道，莫斯科旅游委员会主席科兹洛夫说，“莫斯科文化节”6月12日至15日在北京举行，这是莫斯科在海外举办的最大规模文化推介项目。
科兹洛夫说：“莫斯科首次如此大规模地在海外展示自己，而北京是首个举办莫斯科主题文化节的城市。‘莫斯科文化节’举办了150多项活动，还包括丰富的商务项目，这有助于展现多元的莫斯科。与‘莫斯科中国春节文化节’一样，这是俄中友好的又一座桥梁。”
莫斯科旅游委员会发布消息称，6月12日至15日，在北京王府井步行街举办的“莫斯科文化节”吸引了超过280万人次参与。
莫斯科旅游委员会援引莫斯科副市长纳塔利娅·谢尔古宁娜的话说：“共285万人次参与此次文化节。他们聆听现代和古典音乐演出，参加舞蹈课堂，品尝俄罗斯美食，学习制作具有民族特色的玩具和纪念品。”（编译/黎然）
6月16日，人们在俄罗斯莫斯科马涅什广场参观。（新华社发）",旅游 # 国际 # 文化,8,912,9,921,https://www.cankaoxiaoxi.com/#/detailsPage/zhongguo/3e7fbba37f6344af912f886051a47038/1/2025-06-19%2013:00?childrenAlias=undefined
16,"参考消息网6月19日报道 据韩联社6月19日报道，韩国军方官员19日表示，朝鲜当天上午10时左右在平壤顺安一带向西北方向发射了10余枚火箭炮，韩美情报部门正在对具体参数进行分析。
报道称，这些火箭炮向半岛西部海域飞行了数十公里。韩国军方推测，朝方此次或动用240毫米口径火箭炮进行射击训练。
此前一天，韩美日三国举行李在明政府成立以来的首次联合空中演习。韩军2架F-15K战机、美军6架F-16战机、日本自卫队2架F-2战机等参加本次演习。
目前朝鲜方面对发射火箭炮一事暂未发布消息。",军事 #国际 #政治,8,539,6,545,https://www.cankaoxiaoxi.com/#/detailsPage/gj/15ed4b45e88f4518bad358805135ddb3/1/2025-06-19%2018:56?childrenAlias=undefined
17,"参考消息网6月19日报道 据韩联社6月19日报道，韩国军方官员19日表示，朝鲜当天上午10时左右在平壤顺安一带向西北方向发射了10余枚火箭炮，韩美情报部门正在对具体参数进行分析。
报道称，这些火箭炮向半岛西部海域飞行了数十公里。韩国军方推测，朝方此次或动用240毫米口径火箭炮进行射击训练。
此前一天，韩美日三国举行李在明政府成立以来的首次联合空中演习。韩军2架F-15K战机、美军6架F-16战机、日本自卫队2架F-2战机等参加本次演习。
目前朝鲜方面对发射火箭炮一事暂未发布消息。",军事 #国际 #政治,8,539,6,545,https://www.cankaoxiaoxi.com/#/detailsPage/gj/15ed4b45e88f4518bad358805135ddb3/1/2025-06-19%2018:56?childrenAlias=undefined
18,"参考消息网6月19日报道 据路透社6月18日报道，美国总统特朗普18日在白宫会见了巴基斯坦陆军参谋长、陆军元帅赛义德·阿西姆·穆尼尔。此次前所未有的会晤可能加剧美国与印度之间的分歧，特朗普声称他叫停了近期印巴之间的战争，但印度对此持有异议。
报道称，此次午餐会是美国总统首次在白宫单独会见巴基斯坦陆军参谋长，后者被广泛认为对巴基斯坦的国家安全政策具有重大影响力。会晤是在没有巴基斯坦文职高官陪同的情况下进行的。
特朗普表示，他很荣幸能与穆尼尔会面，并称双方就伊朗问题进行了讨论。他称巴基斯坦比大多数国家更了解伊朗问题。特朗普向记者表示，他感谢穆尼尔结束了印巴之间的这场战争，同时也称赞印度总理莫迪没有让战争继续下去。特朗普于17日晚与莫迪通话。
特朗普对记者说：“两个非常聪明的人决定不再继续那场战争；那本可能是一场核战争。”
巴基斯坦官员和专家表示，预计穆尼尔将敦促特朗普不要介入以色列与伊朗之间的战争，并寻求停火。
报道指出，特朗普上月曾表示，经美方斡旋，印巴两国在谈判后同意停火，并称在他敦促两国专注于贸易问题而非战争后，敌对行动才宣告结束。
然而，莫迪在17日与特朗普通话时表示，停火是印巴军方通过谈判达成的，而非美国调解的结果。（编译/杨雪蕾）",国际 # 政治 # 军事,8,859,10,869,https://www.cankaoxiaoxi.com/#/detailsPage/gj/f9e97c8e7f8649eb99802eaaff3f94dc/1/2025-06-19%2018:08?childrenAlias=undefined
19,"参考消息网6月19日报道 据亚美尼亚新闻社网站6月19日报道，至少有十处美国在中东的军事设施位于伊朗导弹系统的射程之内。伊朗塔斯尼姆通讯社公布的信息图证明了这一点。
图表显示，美国在巴林、约旦、伊拉克、卡塔尔、沙特阿拉伯、科威特、阿联酋、阿曼、叙利亚和土耳其的军事基地可能会受到伊朗导弹的攻击。
据《华尔街日报》报道，美国总统唐纳德·特朗普私下证实了攻击伊朗的计划。（编译/李莎）",国际 # 政治 # 军事,8,461,10,471,https://www.cankaoxiaoxi.com/#/detailsPage/gj/a64aa3ff07f44807940ebdc8c6826066/1/2025-06-19%2018:08?childrenAlias=undefined
20,"参考消息网6月19日报道 据埃菲社6月18日报道，伊朗驻西班牙大使礼萨·扎比卜18日说，“如果美国人向我们开一枪，他们的军事基地就将成为我们的合法目标”。
扎比卜接受了西班牙塞尔广播电台一个节目的采访。当被问及对美国可能对以色列和伊朗之间的冲突进行军事干预的看法时，他发表了上述言论。他警告说，伊朗的军事能力“远远超出了他们的想象”。但他补充道，“我们并不寻求扩大战争”。
扎比卜认为，最简单、最可行的和平解决方案是停止对伊朗的侵略。他说：“所有人在这方面都有道德、政治和法律义务。政府、国际组织，甚至公民都有这种道德义务。”
他表示，美国针对伊朗进行军事干预的可能性是存在的，“但当一个国家遭受攻击时，侵略者是单独行动还是与盟友联手已不再重要。当人民遭受攻击时，全国会团结一致，用尽全力反抗侵略者”。
当被问及伊朗是否有足够的军事能力长期抵御以色列的攻击时，这位大使表示，当一个国家遭受攻击时，无论实力如何都必须抵抗到底。（编译/田策）",国际 # 政治 # 军事,8,719,10,729,https://www.cankaoxiaoxi.com/#/detailsPage/gj/545f6b4f388241c8bcdc5013603b6636/1/2025-06-19%2018:08?childrenAlias=undefined
21,"参考消息网6月19日报道 据《日本经济新闻》6月18日报道，日益紧迫的中东局势令想要稳定油价的沙特大伤脑筋。眼下高企的油价固然给包括沙特在内的产油国带来红利，但盲目增产可能导致价格暴跌，这让沙特继续采取谨慎立场。而美国总统特朗普为平抑油价采取的施压行动正在压缩沙特的腾挪空间。
6月13日，以色列对伊朗核设施发动攻击，油价应声大涨。具有指标意义的美国西得克萨斯中间基原油(WTI)期货价格当天一度涨至每桶77.62美元，刷新5个月以来的高点。之后也一直徘徊在70美元区间高位。
虽然以色列和伊朗两国仍在相互报复，但至今尚未对石油供给造成实质性影响。身为石油输出国组织(欧佩克)领袖的沙特现阶段似乎仍选择静观其变。日本能源经济研究所研究主管深沢幸治认为：“近年来，沙特通过外交努力与伊朗构建了良好关系。为避免卷入冲突，沙特似乎不想刺激伊朗。”
油价上涨固然会给沙特带来实惠，但它并没有盲目选择增产。目前的高油价行情主要来自市场对以色列和伊朗爆发军事冲突的担忧情绪，并非石油供给平衡被打破的结果。如果现阶段增加供给，可能无异于亲手打压油价。
国际货币基金组织的数据显示，保持沙特财政平衡所需的油价大约为每桶92美元。也就是说，眼下油价的上涨还达不到让沙特高枕无忧的程度。
大宗商品分析公司克普勒的分析师阿迈娜·贝克尔认为：“既然眼下中东冲突尚未对石油供给产生影响，沙特等产油国不太可能采取特别行动。”
另一方面，不增产将会导致油价在高位徘徊，这可能招致希望油价走低的美国总统特朗普的反感。
据路透社等媒体报道，特朗普12日称“我对最近几天油价上涨很不满意”。之后，随着中东局势恶化，油价开始进一步走高。
高盛公司5月13日发布的一份基于特朗普社交媒体帖文的报告显示，他所期待的油价大概为每桶40至50美元。而眼下每桶70多美元的价格显然偏离了特朗普的目标。
由欧佩克成员国与包括俄罗斯在内的非欧佩克产油国组成的“欧佩克+”机制之所以决定在5月至7月间扩大供给，也是因为美国政府在今年1月举行的达沃斯论坛期间向沙特施加了压力。
日本金属和能源安全组织首席经济学家野神隆之指出：“特朗普在5月访问中东期间刚与沙特就扩大经济和安全领域合作取得成果。沙特还是希望尽可能回应特朗普的期待。”
“欧佩克+”定于7月6日开会再议8月增产事宜。此前确定的目标是，5月至7月日均增产41.1万桶。市场将聚焦于能否维持这一增产幅度。
欧佩克16日发布的月报显示，“欧佩克+”中真正按当前协议执行的八个成员国，5月实际仅环比增产15.4万桶/日，远不及此前设定的目标。在市场看来，即便8月确定继续大幅增产，实际产量也未必能达到预期，因而不太可能产生平抑油价的效果。
受中东局势和特朗普政府政策等引发市场波动的因素夹击，想要稳定油价的沙特愈发难以确定政策方向。（编译/刘林）",国际 # 财经 # 政治,8,1688,11,1699,https://www.cankaoxiaoxi.com/#/detailsPage/gj/ea3e49b7a03243688b834a67eb316862/1/2025-06-19%2018:14?childrenAlias=undefined
22,"参考消息网6月19日报道 据西班牙《经济学家报》网站6月17日报道，全球货币秩序的一个转折点即将到来。数十年来，美元是全球金融体系无可争议的支柱。但在保护主义抬头、贸易规则碎片化以及货币日益被用作地缘政治工具的背景下，美元的信誉开始出现裂痕。在这一充满不确定性的背景下，欧洲面对的是一个掌控自身经济命运的历史性机遇。欧洲央行主张，“全球欧元时刻”已经到来：这是欧元区必须进行深度改革以巩固欧元国际地位的关键时刻。
全球秩序转变
“我们正目睹全球秩序的深刻转变：开放市场和多边规则正在破裂，就连作为该体系基石的美元主导地位也不再稳固。保护主义、零和思维和双边权力竞争正取而代之。这种不确定性正在损害深度融入全球贸易体系的欧洲经济。3000万个就业岗位岌岌可危。”欧洲央行行长克里斯蒂娜·拉加德在《金融时报》和欧洲央行官网全文发表的演讲中表示。然而，她解释说，正在发生的这场实时变革“也为欧洲掌控自身命运以及提升欧元全球重要性提供了机遇”。
目前，从使用量看，欧元是世界第二大货币，占全球外汇储备的20%，而美元的占比为58%。尽管拉加德没有明说，但当一场比赛中的领跑者开始步履蹒跚时，第二名就有机会了，如果其未能抓住机会，则第三名将获胜。
重塑欧元形象
为使欧元发挥其最大潜力，欧洲必须强化三大基本支柱：地缘政治信誉、经济韧性以及法律和制度完整性。
首先，欧元的全球地位基于欧洲在国际贸易中发挥的作用。多年来，欧洲积累了巨额贸易顺差。欧盟是72个国家和地区的主要贸易伙伴，占全球国内生产总值(GDP)的近40%。这反映在欧元作为计价货币的占比上，约为40%。欧盟应通过签署新的贸易协定来利用这一地位。
欧洲央行已经在履行责任，旨在维护全球金融稳定。例如，为防止海外欧元流动性短缺，欧洲央行向关键伙伴提供货币互换和回购额度，以确保其货币政策的顺利传导。
其次，经济实力是任何国际货币的支柱。成功的货币发行者通常具备三个关键特征：强劲的经济增长以吸引投资；深厚且流动性强的资本市场以支持大宗交易；以及广泛的安全资产供应。目前，欧元和欧洲至少部分缺乏这三个特征。欧洲GDP增长乏力；其资本市场流动性充足但尚未百分之百统一；同时缺乏广泛的统一安全资产供应，即没有一种得到所有欧元区国家支持的欧洲债券。目前，这一角色由德国国债承担，但其规模不足以支撑“全球欧元”。
完善单一市场
为使欧元赢得声望，欧洲必须采取果断行动，完成单一市场建设，减少监管负担，并构建强大的资本市场联盟。必须利用欧盟层面的协调政策支持战略性产业，如绿色技术和国防。对国防等公共产品进行联合融资可产生更多安全资产。
第三，投资者对一种货币的信心最终与支撑它的机构的稳健性密切相关。诚然，从外部理解欧盟并不容易。但其结构化、包容性的决策过程确保了制衡、稳定性和政治确定性。对法治的尊重以及欧洲央行等关键机构的独立性，是欧盟应当利用的关键比较优势。
为进一步巩固这些优势，欧盟必须改革欧洲的制度架构。拉加德给出了实现这些变革的关键：“绝对不能允许一票否决权阻碍其他26个欧盟成员国的集体利益。在关键领域更广泛地采用特定多数表决制，将使欧洲能够用一个声音说话。”
带来切实利益
提升欧元的全球地位将带来切实利益：借贷成本降低、减少对货币波动的敞口，以及免受制裁和强制措施的影响。如果欧元达到全球储备货币的地位，欧元区(国家和企业)将能够以更低的利率发债，这将为企业和政府提供更大的支出、消费和投资空间。美国多年来一直利用这一优势举债而不损害自身信誉，并持续超支消费，从而为其民众带来更高水平的福祉。
“历史告诉我们，体系看似坚不可摧，直到坍塌时刻。全球货币主导地位的更迭以前就发生过。这一变革时刻对欧洲而言是一个机遇：这是‘全球欧元’时刻。为抓住这一机遇并加强欧元在国际货币体系中的作用，我们必须作为一个更大限度地掌控自身命运的团结欧洲而果断行动。”拉加德总结道。（编译/韩超）",国际 # 经济 # 财经 # 政治,9,2126,15,2141,https://www.cankaoxiaoxi.com/#/detailsPage/gj/8a1b1edcc970413e92074a768f4e4aa7/1/2025-06-19%2018:14?childrenAlias=undefined
23,"参考消息网6月19日报道 据法新社6月18日报道，法国国防部18日宣布，法国和瑞典两国防长签署了一份路线图，以加强两国在军事装备采购方面的合作。
在巴黎航展期间，斯德哥尔摩向欧洲导弹集团订购了“阿克戎”MP反坦克导弹，巴黎则签署了一份意向书，可能购买瑞典军工业巨头萨博集团生产的“全球眼”预警机，取代法国现有的4架美国制造的预警机。
报道称，这份路线图被介绍为“支持欧洲防务建设的强有力信号”，由法国国防部长塞巴斯蒂安·勒科尔尼和瑞典国防大臣波尔·荣松于18日签署。
该路线图还包括装备瑞典“鹰狮”型战斗机和法国“阵风”战斗机的“流星”空对空导弹，以及可能装备瑞典舰艇的“紫菀”防空导弹。
据法国国防部称，法国还提议将防御和干预护卫舰作为“瑞典新一代水面舰艇计划的候选系统”。
另据路透社报道，瑞典萨博集团18日发布声明称，法国已签署意向书，将采购2架“全球眼”预警机，并保留追加采购2架同款飞机的选择权。
萨博集团未披露该型战机的具体交易价格。萨博集团补充称，最终采购协议或将在未来数月内签署，具体取决于最终谈判结果。
瑞典国防大臣荣松18日在出席巴黎航展后表示，向法国出售该型预警指挥机将使两国共同受益，并提升军事协同作战能力。（编译/杨柯 林晓轩）",国际 # 军事 # 航空 # 合作,8,916,15,931,https://www.cankaoxiaoxi.com/#/detailsPage/junshi/2103f92c7c4442c8a143c0387cc2190f/1/2025-06-19%2017:16?childrenAlias=undefined
24,"参考消息网6月19日报道 据法新社6月18日报道，法国国防部18日宣布，法国和瑞典两国防长签署了一份路线图，以加强两国在军事装备采购方面的合作。
在巴黎航展期间，斯德哥尔摩向欧洲导弹集团订购了“阿克戎”MP反坦克导弹，巴黎则签署了一份意向书，可能购买瑞典军工业巨头萨博集团生产的“全球眼”预警机，取代法国现有的4架美国制造的预警机。
报道称，这份路线图被介绍为“支持欧洲防务建设的强有力信号”，由法国国防部长塞巴斯蒂安·勒科尔尼和瑞典国防大臣波尔·荣松于18日签署。
该路线图还包括装备瑞典“鹰狮”型战斗机和法国“阵风”战斗机的“流星”空对空导弹，以及可能装备瑞典舰艇的“紫菀”防空导弹。
据法国国防部称，法国还提议将防御和干预护卫舰作为“瑞典新一代水面舰艇计划的候选系统”。
另据路透社报道，瑞典萨博集团18日发布声明称，法国已签署意向书，将采购2架“全球眼”预警机，并保留追加采购2架同款飞机的选择权。
萨博集团未披露该型战机的具体交易价格。萨博集团补充称，最终采购协议或将在未来数月内签署，具体取决于最终谈判结果。
瑞典国防大臣荣松18日在出席巴黎航展后表示，向法国出售该型预警指挥机将使两国共同受益，并提升军事协同作战能力。（编译/杨柯 林晓轩）",国际 # 军事 # 航空 # 法国 # 瑞典,8,921,20,941,https://www.cankaoxiaoxi.com/#/detailsPage/junshi/2103f92c7c4442c8a143c0387cc2190f/1/2025-06-19%2017:16?childrenAlias=undefined
25,"参考消息网6月19日报道 美国《国家利益》双月刊网站6月17日刊登一篇文章，标题是《以色列用哪些战斗机袭击伊朗》，作者是哈里森·卡斯。编译如下：
在最近对伊朗的空袭中，以色列部署了一系列美国制造的先进战斗机，参与袭击的3种机型是F-35I“阿迪尔”战斗机、F-16I“风暴”战斗机和F-15I“雷电”战斗机。
作为本轮针对伊朗的“崛起之狮”行动的一部分，以色列出动200多架战机，打击目标包括伊朗核设施和军事基础设施。
F-35I“阿迪尔”战斗机是美国F-35“闪电”Ⅱ型战斗机的定制型号，专为以色列空军量身定制。“阿迪尔”战斗机的特点是以色列开发的航空电子设备、电子战系统和武器，增强了该机型的隐形、精确打击和电子战能力。
在“崛起之狮”行动中，“阿迪尔”战斗机在针对伊朗境内100多个地点的袭击中发挥了重要作用，包括纳坦兹铀浓缩设施、导弹生产基地和防空系统。“阿迪尔”战斗机使以色列空军得以穿透伊朗领空，破坏S-300等先进防空系统，同时最大限度降低风险。“阿迪尔”战斗机证明了以色列在其军事行动中对先进、隐形和精确空中力量的战略重视。
F-16I“风暴”战斗机是为以色列空军研制的F-16D Block 52战斗机的特别改制型号，针对以色列独特的战略和地区需求量身定制。“风暴”战斗机在航空电子设备、生存能力、航程和武器集成方面有显著增强。
“风暴”战斗机 配备保形油箱，相对于标准型F-16，可以携带额外燃料而不占用武器舱，为纵深打击任务提供了便利。“风暴”战斗机还拥有定制的航空电子设备和任务系统，如埃尔比特系统公司的头盔显示器及数据链接，用于与其他平台进行实时协调。
在对伊朗的攻击中，通过发起电子攻击和发射假目标来分散伊朗防空系统的注意力并对其进行压制，“风暴”战斗机被用来支持隐形能力更强的“阿迪尔”战斗机。此外，“风暴”战斗机能够利用其网络作战能力，与作战空间中的其他飞机实时共享目标和威胁数据，增强整个攻击部队的态势感知能力。
F-15I“雷电”战斗机 是F-15E“攻击鹰”战斗机的大幅度修改版本，为深入敌方领土进行远程精确打击进行了优化。以色列用任务计算机、电子战系统和驾驶舱显示器对“雷电”战斗机进行了升级，还为其配备了埃尔塔公司和埃尔比特公司的航空电子设备升级版本和头盔瞄准系统。
在“崛起之狮”行动中，“雷电”战斗机被用来投送用于对加固目标进行猛烈打击的大量有效载荷。“雷电”战斗机也被用于在“阿迪尔”战斗机初步穿透后进行后续攻击，并被用于对导弹仓库、后勤中心和指挥控制中心的辅助攻击。此外，“雷电”战斗机与“风暴”战斗机平台协同使用，提供防空压制和后续突袭。
总而言之，这3款美国制造但经以色列改装的战机被证明擅长执行设计时希望它们执行的任务：深入敌方领土进行远程精确打击。（编译/裘芳）",国际 # 军事 # 政治,8,1651,10,1661,https://www.cankaoxiaoxi.com/#/detailsPage/junshi/5bde2a62e0ed4123b531bb1ae6d57439/1/2025-06-19%2015:28?childrenAlias=undefined
26,"参考消息网6月19日报道 据法国《回声报》网站6月15日报道，本届巴黎航展的飞行表演，可能与此前几届没有太大差别，“阵风”“台风”和F-35等战机仍然都是飞行员在操控。
然而，战机飞行员们在16日开幕的巴黎航展上的吸睛程度可能会有所减弱，在战场上其实也是一样。无人机在战机周围成群飞行，以穿透敌人的防空系统：这一场景可能还没有完全实现，但无人机已经成为所有航空巨头研发的对象，此外更是军用人工智能企业的目标。
德国赫尔辛公司刚刚宣布了一项和瑞典萨博集团合作试验的结果，一架配备人工智能的“鹰狮”战机比飞行员操控的战机具有更大优势。在法国，空军已经在焦急地期待达索公司的未来无人战机，希望它们去伴飞新款“阵风”战机。达索承诺，这将在2032年实现。
波音公司、洛克希德-马丁公司、空中客车防务与航天公司等业界巨头，以及安杜里尔公司等新入局者，都在今年的巴黎航展上亮相。它们都在研发自己的战机伴飞无人机，这些无人机可以诱骗和穿透敌方防空系统，然后让有人驾驶战机进入。空中优势问题从未像如今这样成为西方大国担忧的核心。
法国空天军参谋长热罗姆·贝朗热将军承认，反无人机作战、太空军事化以及核战的回归，对法国军队来说是根本问题。在回答对技术颠覆有什么主要担忧时，他毫不迟疑地说：“只有让人机结合，才能让一名飞行员比敌方更快地分析情况。”
在重新壮大武器装备之际，欧洲企业满足市场需求增长的能力，将会是巴黎航展上的主要问题。爱尔兰埃森哲公司航空和防务业务执行总监让-吕克·布兰古强调，未来的工业战略非常重要，因为欧洲将会变成全球最大的军火市场，到2030年会超过美国。
布兰古指出，为了留在赛道上，空客这样的企业应当和新入局者合作，包括无人机制造企业和人工智能企业。他认为：“军火产业应当从钢铁转向硅。”以发动机制造商赛峰集团为例，该公司最近刚刚收购了法国人工智能企业普雷利让公司。
布兰古还强调，自2022年以来，防务巨头们超过一半的收购主要集中在三个领域：人工智能、网络安全和机器对机器通信。（编译/芦龙军）",科技 # 军事 # 人工智能 # 航空航天 # 国际,8,1280,19,1299,https://www.cankaoxiaoxi.com/#/detailsPage/junshi/c7ebbc8a1f3c4bc2a8f240ab57607d32/1/2025-06-19%2012:48?childrenAlias=undefined
27,"参考消息网6月19日报道 据路透社6月17日报道，本社记者走访发现，美军又从叙利亚东北部的两个基地撤出。美国支持的叙利亚库尔德武装部队指挥官说，美军加速撤离会让“伊斯兰国”组织卷土重来。
本社记者上周走访了这两个基地，发现它们基本空空荡荡，只有少数叙利亚民主力量人员把守。这个库尔德人领导的军事集团过去十年来一直在华盛顿支持下打击“伊斯兰国”组织。
以美国为首的军事联盟所在基地使用的摄像头已经被拆除，外围的铁丝网也开始垂挂下来。
一名住在其中一个基地的库尔德政治家说，该基地已经没有美军了。另一个基地的叙利亚民主力量守卫人员说，美军最近已经离开，但他拒绝透露具体时间。五角大楼也拒绝置评。
这是记者首次实地证实美国已经从哈塞克省的瓦济尔基地和泰勒拜达尔基地撤军。自美国总统特朗普上任以来，美国至少已经从叙利亚的4个基地撤军。
特朗普政府本月表示，将减少在叙利亚的驻军，要把叙利亚民主力量控制的叙东北部地区的8个基地减少到1个。《纽约时报》4月份报道，在撤军过程中，美军数量可能从2000人减少到500人。
叙利亚民主力量没有回应有关目前美军人数和在叙利亚东北部开放的美军基地数量的问题。
但叙利亚民主力量指挥官马兹卢姆·阿卜迪对本社记者说，在一个基地驻扎几百名士兵“不足以”遏制“伊斯兰国”组织的威胁。（编译/卢荻）",国际 # 政治 # 军事,8,921,10,931,https://www.cankaoxiaoxi.com/#/detailsPage/junshi/a62ce6590161467ca1628e07f5100215/1/2025-06-19%2012:54?childrenAlias=undefined
28,"参考消息网6月17日报道 美国《国家利益》双月刊网站6月15日刊登一篇文章，标题是《俄罗斯罕见的米格-35战斗机才刚刚起步》，作者是布兰登·韦彻特。编译如下：
俄罗斯正在证明自己是一个真正的大国，拥有强大的国防工业基础，而且与西方军事战略家的期望相反，制裁无法遏制俄罗斯。俄方已熟练掌握将老旧武器系统升级改造为现代战场关键装备的技术能力。
米格-35第4++代多用途战斗机就是其中的一个。俄罗斯正着力将这个机型打造为对北约部队构成重大威胁的武器系统。该机型由俄罗斯米高扬设计局设计。米格-35战机由苏联时代传奇机型米格-29系列演化而来，俄罗斯将其定位为连接第四代与第五代战机的技术桥梁。其核心战略是与更现代的北约现役主力战机形成对抗，诸如洛克希德-马丁公司的F-35“闪电”Ⅱ型战斗机和F-16“战隼”等北约战机。
米格-35战机在2017年莫斯科航空展上首次在国际上亮相，并从2019年起列装俄罗斯空天军。该战机由2台克利莫夫RD-33MK加力式涡轮风扇发动机提供动力，在无外挂油箱的情况下，可实现2.25马赫的最大飞行速度和约1242英里（约合2000公里）的作战半径。其先进的电传系统和高机动性能让飞机胜任制空任务，同时，其与各种空对空和空对地弹药的兼容性增强了其多用途潜力。
米格-35战机的突出特点之一，是该机型装备的俄罗斯法佐特龙公司生产的“甲虫-AE”有源电子扫描阵列雷达。据报道，该雷达可以在大约100英里的距离上同时探测和跟踪多达30个目标。该雷达与现代电子战系统相结合，可以提供增强型态势感知能力及抗干扰性能。该机型进一步采用了雷达吸波涂层等低可探测性设计，尽管其隐身能力尚未达到F-35或苏-57等第五代战机的标准水平。
这些特性让米格-35战机成为一种多用途作战平台，其设计目标是在高强度对抗战场环境中同时打击空中与地面目标。
米格-35战机的开发具有双重目的。一是实现俄罗斯空军现代化，同时吸引出口客户，特别是在成本因素压倒尖端隐身技术需求的地区。
当谈到制衡北约时，米格-35战机的研发目标明确针对广泛部署的F-16和“台风”战斗机，并兼顾对抗F-35。米格-35战机的设计强调机动性、成本效益及更高的飞行员操作门槛，这与俄罗斯在空战场景中更喜欢机动性而不是隐身效果的整体作战理论保持一致。
更重要的是，米格-35战机在乌克兰等高对抗密度空域的作战能力，理论上使其具备对北约实施空战的适配性，后者高度体系化的防空网络构成重大威胁。
尽管如此，米格-35的作战历史凸显了它在有效竞争方面的困难。尽管该机型已于2019年投入使用，但据估计交付给俄罗斯空天军的数量极少，可能不足10架。因此，出于保护俄罗斯最好的空中资产的愿望，这种战机的作战用途有限。有报道称，米格-35战机在乌克兰的部署很少。最近在俄罗斯5月举行的一年一度的大规模纪念二战胜利阅兵式上，米格-35战机还被派去保卫莫斯科免受无人机袭击。
这种缺乏实战测试的情况令人质疑其在实际作战环境中的可靠性和有效性，尤其是在与F-16战机进行对比时。F-16战机拥有包括海湾战争和中东地区多场军事行动在内的丰富实战记录。
然而，今天，随着俄罗斯国防工业基础处于冷战时代以来最有效的生产水平，俄罗斯正致力于确保米格-35战机获得公平的竞争机会。莫斯科表示希望将苏-57的更多系统集成到米格-35战机中，以使其更具竞争力。目前正在推动该系统的批量生产，使其更适用于前线作战行动。
美国应该预料到，未来会有更多米格-35战机投入现役，其部署频率将逐步提升，且技术复杂度远超前代机型。（编译/杨柯）",军事 # 国际 # 政治,8,2121,10,2131,https://www.cankaoxiaoxi.com/#/detailsPage/junshi/635f5fbbc31a4b77b6c5b6f87aba46d3/1/2025-06-17%2010:41?childrenAlias=undefined
29,"参考消息网6月17日报道 《俄罗斯商业咨询日报》网站6月16日发表题为《斯德哥尔摩国际和平研究所预测新的核军备竞赛》的报道称，核武器削减时代已走向终结，核军备竞赛正逐渐加速，伴随而来的风险将比冷战时期更加复杂严峻。这是斯德哥尔摩国际和平研究所（SIPRI）分析人士得出的结论。
据报道，与20世纪不同，如今各国在网络空间、太空和海洋的能力在军备竞赛中扮演着重要角色。现在确定谁在军备竞赛中领先要困难得多，而过去用于军备控制的模式已经不够了。此外，在一些欧洲、中东和东亚国家，关于获取核武器的讨论已重新开始，这表明核国家俱乐部有扩大的潜在可能性。
分析人士指出了核武器领域的三大趋势。首先，在对核武器控制减弱的背景下，核武库的现代化正在进行中。其次，一些国家的核学说发生了变化。最后，“核共享”的实践正在扩大。
根据SIPRI的评估，截至2025年1月，全世界有12241枚核弹头。其中9614枚属于军用库存——这是指安装在导弹上、存放在作战部队军火库里的弹头，以及储存在仓库中可用于部署的弹头。剩下的2627枚属于已退役但尚未销毁的类别。
全球近90%的核武器和所有退役弹头都集中在俄罗斯和美国——它们的军用库存类型弹头分别为4309枚和3700枚。与2024年相比，它们的核武库几乎没有变化，但SIPRI指出，俄美两国都在积极推进核武器现代化，这可能“扩大它们未来的核武库规模和多样性”。这将在2026年2月《新削减战略武器条约》到期后成为可能——该条约是限制俄罗斯和美国核武库的最后一份文件。
SIPRI的评估指出，2024年美国和俄罗斯的核武器现代化计划都遇到了挑战。美国出现了规划和资金方面的问题，这可能会延长项目周期并增加成本。同时，一些数据显示，俄罗斯在2024年“萨尔马特”洲际弹道导弹试验中遇到了问题，其他系统的更新也比预期进度要慢。不过，专家们认为，在未来几年，俄罗斯和美国很可能会更积极地部署其核力量。（编译/魏良磊）",国际 # 政治 # 军事 # 核武器,8,1279,14,1293,https://www.cankaoxiaoxi.com/#/detailsPage/junshi/863052796c864d7a926cfbe20c958eba/1/2025-06-17%2010:26?childrenAlias=undefined
30,"参考消息网6月19日报道 德国新闻电视频道网站6月17日刊登题为《这就是为什么美国参战如此危险》的文章，作者是弗劳克·尼迈尔。文章摘译如下：
在以色列对伊朗的袭击中，有一点显而易见：国际原子能机构确认伊朗地上核设施遭受了严重破坏，但位于地下100米处的福尔道核设施却未遭到攻击。伊朗最宝贵的设施和技术实力都深藏于地下，迄今为止得到了很好的保护。
这会不会挑起美国参战的野心呢？特朗普最近要求德黑兰“无条件投降”，但可以预见，伊朗几乎不可能接受这一要求。那么，美国总统真的在考虑攻击伊朗吗？
虽然当前无法完全排除这一可能，但无论伊朗此刻显得多么虚弱，仍有一些因素表明美国似乎不会介入这场冲突，尤其从美国自己的视角来看。
以色列国防军预备役少将、国家安全委员会前主席吉奥拉·埃兰德说：“参战与美国总统的理念相悖。”实际上，反复无常的特朗普在这方面的看法却相当坚定——在过去20年里，美军在海外的行动并没有给美国带来好处。特朗普正急于从中东撤军，如果美国对伊朗发起军事行动，将完全违背这一方针。
“美国优先”是特朗普政府的信条，这应主要体现在经济政策上。但如果特朗普对伊朗发动大规模攻击，那么德黑兰可能会封锁霍尔木兹海峡作为回应，那里是全球最重要的航运路线之一。奥地利中东问题专家马蒂亚斯·瓦辛格上校说：“这将再次引发影响全球的冲击波。这不符合特朗普让资金回流美国的叙事。”
此外，这名军事专家认为，美国攻击伊朗的地下核设施在技术上完全可行，但风险无法估量：“一旦这些设施中的放射性物质泄漏并引发一系列后续反应，那么美国就再也无法为自己的行为辩解了。”
因此，或许到头来，参战对美国来说并不像最初看上去那样诱人。（编译/宋羽豪）",国际 # 政治 # 军事,8,1087,10,1097,https://www.cankaoxiaoxi.com/#/detailsPage/guandian/2022c76847d44d39ae1a37f8e3e707d1/1/2025-06-19%2014:09?childrenAlias=undefined
31,"参考消息网6月19日报道 德国新闻电视频道网站6月17日刊登题为《这就是为什么美国参战如此危险》的文章，作者是弗劳克·尼迈尔。文章摘译如下：
在以色列对伊朗的袭击中，有一点显而易见：国际原子能机构确认伊朗地上核设施遭受了严重破坏，但位于地下100米处的福尔道核设施却未遭到攻击。伊朗最宝贵的设施和技术实力都深藏于地下，迄今为止得到了很好的保护。
这会不会挑起美国参战的野心呢？特朗普最近要求德黑兰“无条件投降”，但可以预见，伊朗几乎不可能接受这一要求。那么，美国总统真的在考虑攻击伊朗吗？
虽然当前无法完全排除这一可能，但无论伊朗此刻显得多么虚弱，仍有一些因素表明美国似乎不会介入这场冲突，尤其从美国自己的视角来看。
以色列国防军预备役少将、国家安全委员会前主席吉奥拉·埃兰德说：“参战与美国总统的理念相悖。”实际上，反复无常的特朗普在这方面的看法却相当坚定——在过去20年里，美军在海外的行动并没有给美国带来好处。特朗普正急于从中东撤军，如果美国对伊朗发起军事行动，将完全违背这一方针。
“美国优先”是特朗普政府的信条，这应主要体现在经济政策上。但如果特朗普对伊朗发动大规模攻击，那么德黑兰可能会封锁霍尔木兹海峡作为回应，那里是全球最重要的航运路线之一。奥地利中东问题专家马蒂亚斯·瓦辛格上校说：“这将再次引发影响全球的冲击波。这不符合特朗普让资金回流美国的叙事。”
此外，这名军事专家认为，美国攻击伊朗的地下核设施在技术上完全可行，但风险无法估量：“一旦这些设施中的放射性物质泄漏并引发一系列后续反应，那么美国就再也无法为自己的行为辩解了。”
因此，或许到头来，参战对美国来说并不像最初看上去那样诱人。（编译/宋羽豪）",国际 # 政治 # 军事 # 外交,8,1091,14,1105,https://www.cankaoxiaoxi.com/#/detailsPage/guandian/2022c76847d44d39ae1a37f8e3e707d1/1/2025-06-19%2014:09?childrenAlias=undefined
32,"参考消息网6月19日报道 美国《纽约时报》网站6月16日刊登题为《我们的桥梁老旧，我们的电网出现故障，美国很快将会被淘汰》的文章，作者是播客主持人吉加·沙阿和新兴创意公司首席执行官拉杰·潘努。文章摘编如下：
美国正在梦游般陷入一场基础设施危机——这场危机将会悄无声息地降低我们的生活质量并且削弱我们在全球经济中的竞争能力。不仅仅是老旧基础设施需要维修和更换，还要支持新系统，比如人工智能。
这场危机要求国家重新致力于现代化——不是作为党派项目，而是作为全球竞争力、国家安全和日常生活中基本尊严的先决条件。
如今，美国桥梁的平均使用年限超过40年，其中约有4.2万座存在结构缺陷。我们的港口是工业化国家当中自动化程度最低的，这导致了更高的成本和附近社区的危险污染。
美国的电网也捉襟见肘。根据北美稳定供电公司的数据，美国去年冬季约有三分之二的地区面临停电风险上升。我们无法把电力从产能过剩的地区输送到需要的地方，因为我们没有建设足够的输电线路。在一个越来越多地由机器智能驱动的世界里，如果你的电力中断，你的经济就会停摆。
电力需求正在迅速增加。现在，训练一个大型人工智能模型所需的电力相当于美国一个大型城市社区一年的用电量。数据中心为从语言模型到高级模拟的一切东西提供动力，预计到2030年将消耗美国约10%的电力供应，而目前约为2%。除非我们积极扩大能源生产并且建设输电线路，否则未来繁荣的明灯将开始闪烁不定。
不稳定的基础设施不仅仅是科技行业的问题。在美国努力恢复制造业之际，支撑制造业的基础设施却远未准备就绪。自2021年以来，已经公布了920多家新建或扩建的制造业工厂，这些项目将在美国国内生产半导体、电动汽车、电池、关键矿物加工和其他部件。
有一段时间，美国似乎在认真对待基础设施现代化的问题：拜登政府试图加快审批，改善输电规划，并且释放了数千亿美元的联邦资金用于升级。当时确实动力十足。
自那之后，围绕政府拨款和债务上限问题反复采取边缘政策使这些成果陷入不确定状态。能源部和运输部关键办公室的资金也被推迟拨付。众议院提议取消数十亿美元的清洁能源税收抵免，并且收回未动用的《通胀削减法案》资金，这进一步打击了投资者信心。
这一切都发生在我们的竞争对手快速建设的时候。中国将在人工智能、机器人和智能基础设施方面投入巨额资金。欧洲正在对港口、公路和数字网络进行现代化改造，以保持竞争力。
提升支撑美国竞争力的基础设施应该从电网开始。国家输电战略必须成为整合清洁能源发电、大型电池和灵活性的经济政策的基石。没有它，我们就无法在需要的时候把电力输送到需要的地方，我们最有前途的技术将会消亡。
我们还必须确保美国的创新留在美国本土。联邦投资应该侧重于扩大美国发明的技术，比如先进核反应堆、清洁氨生产、关键矿物加工和下一代电池化学。它们是清洁和有韧性的未来工业基石，如果没有政府的战略支持，它们就会被建在其他地方。
如果国会和特朗普政府现在不采取行动，美国将只能在21世纪的世界里使用20世纪的工具。（编译/葛雪蕾）",科技 # 社会 # 政治,8,1631,10,1641,https://www.cankaoxiaoxi.com/#/detailsPage/guandian/b04b518e30fc4b61b34efc445b9d35f8/1/2025-06-19%2014:06?childrenAlias=undefined
33,"参考消息网6月19日报道 日本《读卖新闻》6月18日发表题为《中东危机蔓延，当务之急是避免全面战争》的社论。内容摘译如下：
以色列与伊朗的冲突已经发展为猛烈攻击对方重要城市的非常事态。为切断相互报复的连锁反应，国际社会必须一致要求双方停火。
继空袭伊朗核设施后，以色列连日来又对伊朗的重要能源基地发动打击。目前打击范围已扩大至伊朗的国营电视台、政府机构和医院等非军事设施。另一方面，伊朗也动用导弹和无人机打击了以色列中部城市特拉维夫及其周边区域。
这一次以色列以伊朗的核研发活动威胁本国存亡为由，进行了所谓“先发制人”的打击。但是伊朗正在就核问题与美国间接谈判，谈得上对以色列的威胁已经迫在眉睫吗？
大规模军事行动导致的混乱或久拖不决，进而威胁到整个中东，这是国际社会不能允许的。
首先，对以色列拥有影响力的美国应当施加压力，要求其保持克制。
七国集团（G7）领导人峰会是一个就中东局势深入交流的好机会，特朗普总统本人也出席了会议，但还是以专心处理中东问题为由提前离场。
欧洲领导人的亲以色列立场不禁让人产生违和感。G7发表的有关中东局势的联合声明中明确提及“以色列拥有自卫权”。
这不仅不能止战，反而可能让以色列的气焰更加嚣张，更让G7存在的意义面临考验。（编译/刘林）",国际 # 政治 # 军事,8,891,10,901,https://www.cankaoxiaoxi.com/#/detailsPage/guandian/da28592cae3e4fe8bd28d0c78e37d4e6/1/2025-06-19%2014:06?childrenAlias=undefined
34,"参考消息网6月19日报道 美国《纽约时报》网站6月16日刊登题为《特朗普的伊朗选择：最后的外交还是钻地炸弹》的文章，作者是戴维·桑格。文章摘译如下：
在以色列和伊朗之间的战事持续之际， 特朗普总统正在权衡一个关键决定：美国是否要卷入这场乱局，帮以色列摧毁深埋在福尔道地下的伊朗核浓缩设施？只有美国B-2轰炸机投下的“地堡克星”炸弹才具有这种威力。
如果他决定这样做，美国将成为中东这场新冲突的直接参与者并与伊朗为敌，从而卷入特朗普在两次竞选中都信誓旦旦要避免的那种战争。伊朗官员已经警告称，美国一旦参与对伊朗核设施的袭击，就可能毁掉达成核协议的残余可能性，而特朗普坚称自己仍希望达成这一协议。
但是，如果外交努力失败，或是伊朗方面仍然不愿屈服于特朗普的核心要求（即最终结束伊朗境内的一切铀浓缩活动），特朗普仍然可以选择下令摧毁福尔道和其他核设施。
专家们认为，只有一种武器可以完成这个任务。这种炸弹被称为重型钻地炸弹，又名GBU-57。它重达3万磅，只有B-2轰炸机才能搭载。以色列既不拥有这种炸弹，也没有能够运载它抵达目标上空的轰炸机。
“福尔道一直是这项任务的关键点，”曾为小布什和拜登等连续四位美国总统处理中东事务的布雷特·麦格克说，“如果最终福尔道仍在进行铀浓缩，那就谈不上战略胜利。”
自小布什政府以来，内塔尼亚胡一直敦促美国提供“地堡克星”，截至目前都未能如愿。
但 现在压力增加了。16日，因与内塔尼亚胡不和而辞职的以色列前国防部长约亚夫·加兰特对美国有线电视新闻网的主播说：“这件事必须做，由以色列来做、由美国来做。”他显然指的是必须由一名美国飞行员驾驶一架美国飞机投下炸弹。他说，特朗普“可以选择改变中东，影响世界”。
但在这个问题上，美国共和党人的态度并不一致，也凸显了更深层次的分歧。这不仅关系到瘫痪福尔道的离心机，还关乎“让美国再次伟大”（MAGA）的观点，即哪些战争是美国应该不惜一切代价来避免的。
共和党的反干涉派（以颇具影响力的播客主播塔克·卡尔森为代表）辩称，伊拉克和阿富汗的教训是，陷入另一场中东战争只会让美国面临衰落风险。13日，卡尔森写道，美国应该“放弃以色列”，“让他们打自己的战争”。
目前，特朗普还能两头下注。通过再一次的强制外交，他可以向MAGA的信徒证明，他正在利用重型钻地炸弹发出威胁，让这场冲突走向和平。他可以告诉伊朗人，他们必须以某种方式停止铀浓缩活动，要么通过达成外交协议，要么让GBU-57炸弹来实现这一点。
但是，如果这种说服和胁迫相结合的做法失败了，他将不得不作出决定：这是以色列的战争还是美国的战争。（编译/朱丽）",国际 # 政治 # 军事,8,1613,10,1623,https://www.cankaoxiaoxi.com/#/detailsPage/guandian/5b1f245137b9460296ab33250c735ccc/1/2025-06-19%2014:06?childrenAlias=undefined
35,"参考消息网6月19日报道 香港《亚洲周刊》6月23日（提前出版）一期刊登题为《苏超足球火爆之风启示粤港澳》的文章。内容摘编如下：
近日，中国内地“苏超”成了流量密码。“苏超”是业余性质的江苏省城市足球联赛，由江苏省内13个城市各派一队参加。江苏省通过“玩梗”，以当地人熟知的典故、“地域黑”迅速爆红，并带动外围的文化旅游，成为全国瞩目的流量密码。
“苏超”意外爆红，一方面显示江苏主办方熟悉网络语言，另一方面也代表国民普遍厌倦国足的低水平表现，既然都是低水平，不如看令自己开心愉快的比赛。“苏超”的红火对全国来说都是重要启示，既可以通过“X超”的形式炒旺流量，吸引游客，也可以推广足球风气，播种于民间以待来日。
2023年，贵州“村超”走红。“村超”当时就与“嘉年华”式的娱乐紧密相连，中场休息和比赛结束的暖场环节则会有各个苗村侗寨自发组织的暖场活动，比如芦笙舞、木鼓、琵琶、多耶舞、少儿体操和侗族大歌等。而且“村超”每场比赛获胜的球队奖励两只猪脚，具有浓厚的乡土气息。
时隔两年，“苏超”在商业运作上更加成功，撇去了农村味，贩卖的是江苏省内“十三太保”的地域恩怨情仇。如南京与南通的“南哥德比”演变为“比赛第一，友谊第十四”的口号，无锡球迷用“水蜜桃加盐”调侃南京失利。这种地域文化在欧洲由来已久，例如英国的“玫瑰德比”，是指曼彻斯特市与利兹市的长期斗争。
“苏超”吸纳了西化的地域角力的足球文化，但却把背后的地域恶性斗争元素去除，变成彬彬有礼的良性互动，如常州对扬州游客免票、泰州向客队球迷赠送早茶，让足球变成了大众参与的文旅活动。
“苏超”红火对各大城市的旅游业都有显著促进作用，中国各地也如雨后春笋般仿效。如广东省足协官网发布通知称，2025赛季“粤超”将于7月至10月举行，共将有16支球队参赛，每队可注册三名港澳台球员，届时每场可同时上场两人。“苏超”通过地域差异创造的良性互动对“粤超”也是一个启示。
贵州“村超”与“苏超”的红火均有助于足球作为全民文化的推广，让每个人都有参与足球运动的机会，不只是喝着啤酒、嚼着薯片在电视机前看热闹，而是有机会站在绿茵场上献技较量。
中国足球长远要两条腿走路，既要办好以全民运动推广为目标的“村超”“苏超”，也要办好以职业化、高竞技水平、可以立足于世界顶尖水平之林的“中超”。前者让大众有参与的机会，后者则是让中国职业球员可以接受高水平的竞技，与世界接轨。",体育 # 社会 # 教育 # 娱乐,8,1550,15,1565,https://www.cankaoxiaoxi.com/#/detailsPage/guandian/efe8938d005a4fd9ad1af4b0520cd5a3/1/2025-06-19%2014:49?childrenAlias=undefined
36,"参考消息网6月19日报道 俄罗斯《消息报》网站6月17日刊登题为《中式外交》的文章，作者是达里娅·萨普伦斯卡娅。文章摘编如下：
近年来，中国成功重构了与中亚国家的合作方式：“C5+1”(中亚五国+中国)形式的部长级会议从2020年起开始举办。2023年中国和中亚国家在西安举行首届中国—中亚峰会并签署《西安宣言》后，中国国家主席习近平提出的人类命运共同体理念开始在中亚得到积极推行。第二届中国—中亚峰会17日在哈萨克斯坦举行，它是中亚国家与中国有关合作方向的对话的延续。
本届峰会和习近平主席此次哈萨克斯坦之行一样，都是在世界冲突激化和国际政治局势复杂化的背景下进行的。一些媒体称，中国希望建立一个在未来中美对抗中可以依靠的“忠诚联盟”。但中方始终坚持与中亚和平共处的理念，从峰会上讨论的内容看，核心议程也与此无关。
显然，习近平主席的访问侧重于该地区发展的几个关键要点——能源、运输走廊和数字化。当然，峰会期间签署的文件不会仅限于这三方面，因为与中国合作的机会正变得越来越多。例如，在哈萨克斯坦，不仅传统的中文学习中心纷纷涌现，还成立了不少研究中国现代化、科学和技术转让问题的专门分析机构。换句话说，中方正在各领域积极开展活动以加强协作，而且这些活动也相当富有成效。
对于中亚而言，与中国的经济协作拥有坚实基础。例如，哈萨克斯坦总统托卡耶夫称，“中国在讨论大型经济项目时从不附加政治条件”，而且能快速履行所有协议。对于该地区国家来说，这一论断十分重要，因为它们正在与中方实施众多经济项目。
回到经济问题上，能源对中国很重要。尽管世界经济出现了某种减速，但中国的实力并未减弱，因此市场需求没有下降。有消息称，哈萨克斯坦已与中国电力建设集团在第二届中国—中亚峰会期间签署了协议。
中国对中亚国家基础设施和物流潜力的建设已实施相当长时间。除了共建“一带一路”倡议框架内的项目外，中国还积极吸引中亚参与中巴经济走廊建设。这一战略中的关键项目包括已启动的中吉乌铁路和对跨阿富汗铁路的支持。
所有这些项目不仅能通过促进贸易交流来改变该地区状况，还将成为向世界传播中国理念的支持性力量。（编译/刘洋）",国际 # 政治 # 经济 # 一带一路,8,1290,13,1303,https://www.cankaoxiaoxi.com/#/detailsPage/guandian/0d49808c0ebb4ea682a049170d47d680/1/2025-06-19%2009:14?childrenAlias=undefined
37,"外文全称：GlobalEye
中文译名：“全球眼”预警机
背景介绍：据路透社6月18日报道，法国已签署意向声明，将从瑞典萨博集团购买两架“全球眼”预警机。2018年2月，萨博推出了第一架“全球眼”预警机并在同年3月进行了首飞。“全球眼”装载了“爱立眼”机载预警雷达，该雷达重约1吨，安装在机身上部，其作用距离可达550公里。“全球眼”可同时执行空中、海上和地面监视任务。",科技 # 军事 # 国际,8,471,10,481,https://www.cankaoxiaoxi.com/#/detailsPage/ym/f3748c8266bd496f93a0351d572dcd38/1/2025-06-19%2010:48?childrenAlias=undefined
38,"外文全称：GlobalEye
中文译名：“全球眼”预警机
背景介绍：据路透社6月18日报道，法国已签署意向声明，将从瑞典萨博集团购买两架“全球眼”预警机。2018年2月，萨博推出了第一架“全球眼”预警机并在同年3月进行了首飞。“全球眼”装载了“爱立眼”机载预警雷达，该雷达重约1吨，安装在机身上部，其作用距离可达550公里。“全球眼”可同时执行空中、海上和地面监视任务。",军事 #科技 #国际,8,467,6,473,https://www.cankaoxiaoxi.com/#/detailsPage/ym/f3748c8266bd496f93a0351d572dcd38/1/2025-06-19%2010:48?childrenAlias=undefined
39,"外文全称：Brad Lander
中文译名：布拉德·兰德
背景介绍：据法新社6月17日报道，纽约市审计长、2025年纽约市长热门候选人布拉德·兰德，当天遭移民与海关执法局逮捕。兰德旁听了一场涉及可能被驱逐出境人员的移民听证会。兰德出生于1969年，民主党籍，曾就读于芝加哥大学、伦敦大学和普拉特学院。兰德曾于2009年当选为纽约市议员，任职12年，自 2022年起担任纽约市审计长。",政治 # 社会 # 国际,8,485,10,495,https://www.cankaoxiaoxi.com/#/detailsPage/ym/0f1692726d474eef886d5c8faed97175/1/2025-06-18%2010:13?childrenAlias=undefined
40,"外文全称：Khawaja Muhammad Asif
中文译名：赫瓦贾·穆罕默德·阿西夫
背景介绍：据法新社6月16日报道，巴基斯坦国防部长赫瓦贾·穆罕默德·阿西夫呼吁所有穆斯林国家在以色列袭击伊朗后团结起来对抗以色列。他警告说，如果不采取联合行动，只会鼓励中东地区发生更多袭击。阿西夫出生于1949年，拥有经济学硕士学位，曾任外交部长等职务，2022年出任国防部长。",国际 # 政治 # 社会,7,447,10,457,https://www.cankaoxiaoxi.com/#/detailsPage/ym/da9696f388454b29a86cf1fb1569838e/1/2025-06-17%2010:08?childrenAlias=undefined
41,"参考消息网6月16日报道（文/苏佳维）近日，美国《华尔街日报》报道，随着美国不少州立大学的学生不断减少，许多依赖大学来维持增长的周边城镇经济遭受重创。美国大学城（college town）从繁荣走向萧条（from boom to bust），“新锈带（new Rust Belt）”也随之逐渐显现。
“锈带（Rust Belt）”通常指美国中西部五大湖一带的传统重工业衰退区，这里曾是美国的工业心脏（industrial heartland）。“锈带”一词源于1984年民主党总统候选人沃尔特·蒙代尔对竞争对手、共和党候选人罗纳德·里根的自由主义贸易政策的指责，蒙代尔称里根的政策“将美国工业发达的中西部变成一只锈掉的碗（turning our industrial Midwest into a rust bowl）”。当时有用“带（belt）”来指代美国特色区域——如“阳光带（Sun Belt）”“玉米带（Corn Belt）”等——的命名风潮，媒体迅速将“锈碗（rust bowl）”改写为“锈带（Rust Belt）”，并将这个充满贬损意味的标签加诸于美国的传统工业核心区。
当前美国各地出现的“新锈带”危机源于三重结构性冲击。首先是“入学悬崖（enrollment cliff）”，数据显示，美国高中毕业生人数将从明年春季开始下降，这必然对大学入学人数产生影响。其次，美国高等教育正面临前所未有的“价值质疑”，不断攀升的高昂学费与其带来的日益模糊的就业回报促使更多学生选择直接工作而非升学。再者，特朗普政府的教育政策进一步加剧困境——联邦资金削减（federal-funding cuts）与国际学生签证限制的双重压力，沉重打击了那些本就依赖州外学生高学费和联邦资助生存的公立大学的财政。
这一冲击并非均匀分布，而是呈现强烈的“极化效应（polarization effect）”。《华尔街日报》对美国748所公立四年制院校进行分析后发现，从2015年到2023年，最知名的州立大学的全日制和非全日制入学人数增加了9%，但那些知名度较低的区域性公立院校的入学人数却下降了2%。这种分化拉大了经济差距——名校所在地区的经济增长率往往是普通大学所在地区的两倍以上。精英院校宛如巨大的“黑洞”，源源不断地虹吸资源、人才与关注，加速边缘院校及其周边城镇的消亡。
这一趋势正在持续敲响警钟：未能成功转型或缺乏顶尖资源加持的美国大学城正迅速沦为知识经济时代的下一张脆弱骨牌。",教育 # 社会 # 经济,9,1349,10,1359,https://www.cankaoxiaoxi.com/#/detailsPage/ym/57bda364f5c9444e91c29184e01cbb19/1/2025-06-16%2014:22?childrenAlias=undefined
42,"参考消息网6月16日报道（文/张熠柠）过去一周，美以与伊朗紧张关系再次骤然升级。一个值得玩味的细节是：以色列和伊朗在言语交锋中都提到了“狮子”。
一方面，以色列将这一轮针对伊朗的军事行动命名为“崛起之狮（Rising Lion）”。路透社发文解释说，这一名称出自希伯来圣经《民数记》，“这民起来，仿佛母狮（the people shall rise up as a great lion）”，以“狮子不吃饱就不停歇（a lion that will not rest until it has satisfied its hunger）”作比，预言以色列的强大和胜利。
另一方面，伊朗政府发表声明说，“向伊朗开战有如戏耍狮尾（starting a war with Iran is playing with the lion's tail）”。从字面看，“戏耍狮尾（play with the lion's tail）”与英文短语“玩火（play with fire）”十分相像，都形象地指代极其危险而且具有主观故意的行为。
近年来，伊朗官方不止一次如此警告。2018年7月，伊朗时任总统鲁哈尼发表电视讲话，要求美国不得阻挡伊朗向国际市场出口原油，“别戏耍狮尾，否则会后悔”。相比“玩火”，“戏耍狮尾”的伊朗特色更加鲜明：狮子是波斯文化最具代表性的符号之一，在1979年伊斯兰革命前甚至是伊朗国旗的组成元素。
同样以狮子自居的还有英格兰。英格兰的三狮纹章（coat of arms）已有上百年历史，时至今日英格兰足球队仍有“三狮军团”的美名。对于另一个和“戏耍狮尾”形似的英文短语是“twist the lion's tail（拧狮尾）”，柯林斯词典解释为“消磨对方耐心或挑衅对方（to tax the patience of or provoke a person， group， nation， or government）”，同时强调“尤指英国”。前后结合，其含义也就不难理解了。
“戏耍狮尾”还会让人联想到中文的“虎口拔牙”。巧合的是，英文也有“beard the lion in its den（去狮穴剃狮须）”的说法。微妙差别在于，一来“去狮穴剃狮须”强调深入对方地盘，比“虎口拔牙”更多了几分挑衅；二来按照剑桥词典解释，这一短语又指“找到某个重要人物，告诉或询问让对方不快的事”。
事实上，以凶猛著称的狮子并不只有好勇斗狠的蛮力，作为群居猫科动物更有分工合作的智慧。挑起战争不一定需要勇气，但阻止战争一定少不了智慧。愿各方都能不再“玩火”，让中东地区早日远离炮火。",国际 # 政治 # 军事,8,1407,10,1417,https://www.cankaoxiaoxi.com/#/detailsPage/ym/2fc1f1739610492fa3e58f2a2eea02d9/1/2025-06-16%2014:22?childrenAlias=undefined
43,"外文全称：Sayyid Badr Al-Busaidi
中文译名：赛义德·巴德尔·布赛义迪
背景介绍：据法新社6月15日报道，阿曼外交大臣赛义德·巴德尔·布赛义迪表示，由于以色列袭击伊朗，原定在阿曼举行的伊朗与美国第六轮谈判将不再举行。赛义德·巴德尔·布赛义迪出生于1960年，拥有牛津大学硕士学位，1988年开始在外交部任职，2020年8月起担任外交大臣。",国际 # 政治,8,461,6,467,https://www.cankaoxiaoxi.com/#/detailsPage/ym/83d99ab8bcff4d8b95d30abb667ca32f/1/2025-06-16%2010:23?childrenAlias=undefined
44,"参考消息网6月19日报道 据美国《时代》周刊网站6月12日报道，在19世纪结核病疫情最严重的时候，医生建议人们多去户外，以逃离家中的“脏空气”。时间来到20世纪60年代，空调开始在美国普及，人们更愿意呆在室内。如今，我们中的许多人——所谓的“室内一代”——夏天大部分时间都在室内度过，依靠空调来躲避高温。
这项技术真能救命；在危险热浪来袭之时，封闭的恒温空间能够让我们保持凉爽健康。空调还能帮助人们避免室外大气污染，塑造一片“净土”。不过，19世纪的医生对室内空气不流通会对人体产生负面影响的说法有没有道理呢？
这要依情况而定。“多项研究表明，在空调房中呆太久会导致呼吸道症状增加。”约翰斯·霍普金斯医学院肺病和重症监护医生、医学教授威廉·切克利博士说。以下是使用空调的益处、风险以及健康使用空调的简单方法。
空调是安全度过夏季，避免高温相关疾病或更严重疾病的关键。多伦多大学土木工程教授杰弗里·西格尔说：“极端高温造成的死亡人数令人震惊，尤其是老年人和免疫功能低下的人。”从1999年到2023年，美国与高温相关的死亡人数翻了一番。
空调的好处不仅是其冷却效果。切克利说，一个运转良好的空调系统可以过滤空气，减少吸入空气中的灰尘、花粉和病原体。
打开空调也会让空气不那么潮湿。潮湿会滋生细菌、霉菌和尘螨，这些细菌、霉菌和尘螨不利于呼吸系统疾病的好转，在极少数情况下，甚至会导致肺炎、哮喘和慢性阻塞性肺病等疾病。
空调虽好要适度
接下来，我得发出严重警告。如果你过度使用空调，空气就会变得太干燥。切克利说，如果你吸入了大量干燥的空气，人体会向吸入的空气中添加水蒸气，以保持体内的湿度。当你呼气时，潮湿的空气会随着每一次呼吸离开你的身体。
切克利解释说，最终，这会使你的呼吸道变干燥。气道受到刺激并发炎，导致咳嗽、喉咙痛和鼻塞——这种情况被称为“病态建筑综合征”。
空气过于干燥的另一个后果是：肺部对微生物的天然防御能力减弱，增加了对疾病的易感性，尤其是儿童和免疫功能低下的人群。病毒在干燥的条件下更易传播。想想长途旅行时人们长时间处在干燥的机舱环境中，过后很容易生病，就是同样的道理。在家里或办公室里也是如此。
找到湿度平衡点
潮湿会滋生霉菌和尘螨，干燥会导致类似感冒的症状和疾病。当然，也有一个最佳平衡点。切克利说：“家中理想的湿度是在40%到60%之间。”
那么，如何让你的家保持在最佳湿度范围呢？
切克利建议购买一个带有湿度传感器的恒温器，即湿度计，以对温度和湿度进行实时监控。这种仪器虽价格低廉，但精度很高。如果屋内湿度降至40%以下，就让空调休息一下。如果湿度超过了60%，就把空调调大。
空调维护很关键
如果空调的工作状态不佳，即使没有完全损坏，也可能会对健康构成威胁。“真正重要的是空调的运行状况。”西格尔说。
这在很大程度上取决于房屋主人的生活习惯，比如要记得及时更换空调过滤器。专家解释说，如果使用老旧的脏过滤器，空调线圈和管道可能就会变成“霉菌、细菌和过敏原的大杂烩”，这些脏东西会随着空调吹出的冷气进入到空气中。在空调的高频使用期间，应每1至2个月更换一次过滤器。
切克利说，购入额外的过滤器是值得的，可以保持家中的空气质量处于良好水平。
使用空气净化器
虽然你的空调可以清除来自室外的PM2.5污染，但它无法清除另一种来自室内的有害物质：挥发性有机化合物。如果一直开着空调却很少打开窗户，室内的空气可能会聚集这些有害化学物质。
许多家居产品，如家具、清洁用品和空气清新剂，都会释放出潜在的有害挥发性有机化合物。它们会导致头痛、咽喉炎、荷尔蒙紊乱，长期接触还会导致慢性疾病。
经常关掉空调开窗通风，也可以减少挥发性有机化合物。专家称，室内空气中的挥发性有机化合物含量是室外空气的2到5倍。
另一个策略是：购买便携式HEPA空气净化器。最好的版本是带有多孔表面的碳过滤器，可以捕获挥发性有机化合物气体分子，将它们从空气中过滤掉。空气净化器还能帮助去除约50%的PM2.5。
专家补充说，近年来，用于监测PM2.5等颗粒物的低成本监测仪的精度有所提高。一个便宜简便的湿度监测器，加之维护良好的空调，将为你打造凉爽和健康的空间，助你平安度过这个炎炎夏日。（编译/文怡）",健康 # 环境 # 科技,8,2356,11,2367,https://www.cankaoxiaoxi.com/#/detailsPage/kejiyy/4ab1b3066bea4889ab9b0ad399d35c6f/1/2025-06-19%2018:20?childrenAlias=undefined
45,"参考消息网6月19日报道 据美国《时代》周刊网站6月12日报道，在19世纪结核病疫情最严重的时候，医生建议人们多去户外，以逃离家中的“脏空气”。时间来到20世纪60年代，空调开始在美国普及，人们更愿意呆在室内。如今，我们中的许多人——所谓的“室内一代”——夏天大部分时间都在室内度过，依靠空调来躲避高温。
这项技术真能救命；在危险热浪来袭之时，封闭的恒温空间能够让我们保持凉爽健康。空调还能帮助人们避免室外大气污染，塑造一片“净土”。不过，19世纪的医生对室内空气不流通会对人体产生负面影响的说法有没有道理呢？
这要依情况而定。“多项研究表明，在空调房中呆太久会导致呼吸道症状增加。”约翰斯·霍普金斯医学院肺病和重症监护医生、医学教授威廉·切克利博士说。以下是使用空调的益处、风险以及健康使用空调的简单方法。
空调是安全度过夏季，避免高温相关疾病或更严重疾病的关键。多伦多大学土木工程教授杰弗里·西格尔说：“极端高温造成的死亡人数令人震惊，尤其是老年人和免疫功能低下的人。”从1999年到2023年，美国与高温相关的死亡人数翻了一番。
空调的好处不仅是其冷却效果。切克利说，一个运转良好的空调系统可以过滤空气，减少吸入空气中的灰尘、花粉和病原体。
打开空调也会让空气不那么潮湿。潮湿会滋生细菌、霉菌和尘螨，这些细菌、霉菌和尘螨不利于呼吸系统疾病的好转，在极少数情况下，甚至会导致肺炎、哮喘和慢性阻塞性肺病等疾病。
空调虽好要适度
接下来，我得发出严重警告。如果你过度使用空调，空气就会变得太干燥。切克利说，如果你吸入了大量干燥的空气，人体会向吸入的空气中添加水蒸气，以保持体内的湿度。当你呼气时，潮湿的空气会随着每一次呼吸离开你的身体。
切克利解释说，最终，这会使你的呼吸道变干燥。气道受到刺激并发炎，导致咳嗽、喉咙痛和鼻塞——这种情况被称为“病态建筑综合征”。
空气过于干燥的另一个后果是：肺部对微生物的天然防御能力减弱，增加了对疾病的易感性，尤其是儿童和免疫功能低下的人群。病毒在干燥的条件下更易传播。想想长途旅行时人们长时间处在干燥的机舱环境中，过后很容易生病，就是同样的道理。在家里或办公室里也是如此。
找到湿度平衡点
潮湿会滋生霉菌和尘螨，干燥会导致类似感冒的症状和疾病。当然，也有一个最佳平衡点。切克利说：“家中理想的湿度是在40%到60%之间。”
那么，如何让你的家保持在最佳湿度范围呢？
切克利建议购买一个带有湿度传感器的恒温器，即湿度计，以对温度和湿度进行实时监控。这种仪器虽价格低廉，但精度很高。如果屋内湿度降至40%以下，就让空调休息一下。如果湿度超过了60%，就把空调调大。
空调维护很关键
如果空调的工作状态不佳，即使没有完全损坏，也可能会对健康构成威胁。“真正重要的是空调的运行状况。”西格尔说。
这在很大程度上取决于房屋主人的生活习惯，比如要记得及时更换空调过滤器。专家解释说，如果使用老旧的脏过滤器，空调线圈和管道可能就会变成“霉菌、细菌和过敏原的大杂烩”，这些脏东西会随着空调吹出的冷气进入到空气中。在空调的高频使用期间，应每1至2个月更换一次过滤器。
切克利说，购入额外的过滤器是值得的，可以保持家中的空气质量处于良好水平。
使用空气净化器
虽然你的空调可以清除来自室外的PM2.5污染，但它无法清除另一种来自室内的有害物质：挥发性有机化合物。如果一直开着空调却很少打开窗户，室内的空气可能会聚集这些有害化学物质。
许多家居产品，如家具、清洁用品和空气清新剂，都会释放出潜在的有害挥发性有机化合物。它们会导致头痛、咽喉炎、荷尔蒙紊乱，长期接触还会导致慢性疾病。
经常关掉空调开窗通风，也可以减少挥发性有机化合物。专家称，室内空气中的挥发性有机化合物含量是室外空气的2到5倍。
另一个策略是：购买便携式HEPA空气净化器。最好的版本是带有多孔表面的碳过滤器，可以捕获挥发性有机化合物气体分子，将它们从空气中过滤掉。空气净化器还能帮助去除约50%的PM2.5。
专家补充说，近年来，用于监测PM2.5等颗粒物的低成本监测仪的精度有所提高。一个便宜简便的湿度监测器，加之维护良好的空调，将为你打造凉爽和健康的空间，助你平安度过这个炎炎夏日。（编译/文怡）",健康 # 环境 # 科技,8,2356,11,2367,https://www.cankaoxiaoxi.com/#/detailsPage/kejiyy/4ab1b3066bea4889ab9b0ad399d35c6f/1/2025-06-19%2018:20?childrenAlias=undefined
46,"参考消息网6月19日报道 据《西班牙人报》网站6月12日报道，通过把六个不同国家的光学时钟连接，一个国际研究团队进行了迄今为止最全面的光学时钟——一种非常精确的原子钟——协调比较。研究人员在发表于《光学》杂志上的研究中指出，这项跨越数千公里的实验是朝着重新定义“秒”的概念，以及最终建立全球光学时间尺度迈出的重要一步。
研究人员通过在六个国家进行跨越数千公里的光学时钟比较，迈出了建立全球时间新标准的关键一步。
英国国家物理实验室的时间和频率负责人海伦·马戈利斯指出：“原子钟提供的精确时间和频率信号对于许多日常技术至关重要，比如全球定位系统、电网管理和金融交易同步等。”
“我们的发现可以帮助提高下一代光学时钟的性能，这将使全新的应用和依赖于时间和频率的科学进步成为可能。”马戈利斯说。
光学时钟是一种原子钟，使用激光以受控的方式激发原子，从而使其在特定的能级之间跃迁。这种跃迁发生在极其精确的频率上，这些频率相当于普通钟表的“滴答”声。
由于光学时钟以多种形式存在，每种都使用不同的原子来测量时间，因此要充分利用光学时钟的潜力就需要在长距离上进行比较。
此次研究同时使用10个不同的光学时钟，进行了38次比较（频率比）。其中4次比较是首次进行，而其余几次的测量精度也远高于以往实验。
意大利计量科学研究院高级研究员马尔科·皮佐卡罗指出：“这种测量提供了一些关键信息，以便说明光学时钟还需做哪些工作，才能达到国际计时所需的精度和可靠性。”
他还强调，这次实验展示了“整个欧洲的光学时钟如何连接，以最先进的精度测量频率比”，并且创造了一个“分布式实验室”。
数十年来，全球计时标准一直基于分布在世界各地的铯微波原子钟信号的平均值。但是，越来越多的人呼吁使用光学时钟来重新定义国际单位制下的“秒”。
目前光学时钟的精度约为铯原子钟的100倍，其计时精度极高，在数十亿年内的误差不超过1秒。
然而，要将其用于国际计时，需要比较多个光学时钟之间的数据，以验证它们是否正常工作。这正是这项新实验所要完成的工作。
芬兰计量科学中心高级科学家托马斯·林德瓦尔指出：“同时比较多个光学时钟并使用多种链路技术，比之前使用的成对时钟比较能够提供更多关键信息。通过协调一致的测量，可以验证一致性并获得更可靠的信息。这些结果有助于确定在新的‘秒’定义中应该使用哪个或哪些光学时钟。”
为了开展这项研究，科学家们必须将来自不同光学时钟系统的频率信号连接起来。他们使用了两种方法：来自卫星的无线电信号和通过光纤传输的激光。
数据分析工作也给科学家带来了挑战。英国国家物理实验室科学家蕾切尔·戈登指出：“并非所有结果都符合我们的预期，而且我们观察到测量结果中存在一些不一致性。但是，同时比较如此多的光学时钟并使用多种技术将它们连接起来，使得辨别问题根源所在变得更加容易。”
该实验还发现了一些需要进一步展开研究的领域。例如，为了确认所有光学时钟都按预期工作，需要降低测量的不确定性，直到所有时钟的精度达到相同水平。之后必须重复测量以确认运行可靠性，从而增强对时钟和链路的信心。此外在重新定义“秒”之前还必须满足其他多个标准，其中之一就是证明光学时钟能够定期、持续地为国际时间尺度作出贡献。（编译/王萌）",科技 # 国际 # 教育 # 社会,9,1795,14,1809,https://www.cankaoxiaoxi.com/#/detailsPage/kejiyy/af47a1b1a45644419b7f757b01e69306/1/2025-06-19%2018:20?childrenAlias=undefined
47,"参考消息网6月19日报道 据德新社6月17日报道，欧洲研究人员计划在太空建造一座引力波探测站，以获得对宇宙的新见解。
总部位于德国不来梅市的航天装备企业OHB系统公司发言人17日宣布，欧洲航天局和该公司在巴黎航展上签署了激光干涉仪空间天线任务的重要合同。
发言人说，公司已经获得了作为探测站建设主承包商的合同，并补充说，该合同金额达8.39亿欧元。公司计划与合作伙伴一起建造这座探测站。
该任务的核心是由三艘航天器组成一个等边三角形的队形，它们会和地球一起绕着太阳运行。
每艘航天器都将携带由金-铂合金制成的自由漂浮的试验质量块。
OHB系统公司说，在太空中，引力波会扭曲时空，因此也会细微改变试验质量块之间的距离。
该任务由欧洲航天局领导，是欧洲航天局、其成员国、美国国家航空航天局和一个国际科学家联盟之间的合作项目。
欧洲航天局科学主任卡萝尔·芒德尔在声明中说：“作为首个旨在捕捉引力波的太空任务，激光干涉仪空间天线将打开我们了解黑暗宇宙的一扇全新窗口，并最大限度地验证已知的物理学定律。”
OHB系统公司首席执行官基娅拉·佩代尔索利表示，该探测站将使科学家能够用新的眼光观察宇宙。
“就我个人而言，我相信爱因斯坦本人也会很自豪地看到人类通过证明他的理论来传承他的遗产。”佩代尔索利说。
该任务计划于2035年年中发射。（编译/郭骏）",科技 # 太空探索 # 物理学,8,927,12,939,https://www.cankaoxiaoxi.com/#/detailsPage/kejiyy/1899e2a1782f4f6faa0e21df5dd13172/1/2025-06-19%2018:14?childrenAlias=undefined
48,"参考消息网6月19日报道 德国《法兰克福汇报》网站5月14日发表尼娜·穆勒的文章《人工智能代理是新常态》，内容编译如下：
OpenAI、谷歌和微软都押注人工智能代理。就连赛仕这家老派头的技术公司也正在将代理式人工智能整合到其产品中。一股新主流已经确立。
预订航班、规划会议、制定营销战略——人工智能代理被誉为自动化的救星。与聊天机器人不同，它们无需为每项任务接收新指令，而是可以独立决策并完成任务。这项新技术被认为对现有商业模式以及劳动力市场都具有颠覆性：如果工作由数字代理完成，那人类还能做些什么？
人类将成为分配和监督任务的协调者。吉姆·古德奈特的科技公司赛仕已有近半个世纪的历史。这位美国人其实认为生成式人工智能“炒作过头了”，但人工智能代理还是进入了他的云平台。
上周，赛仕(前身为赛仕软件研究所)在佛罗里达州的奥兰多举办了自己的创新大会。这家总部位于北卡罗来纳州的公司主要在专业圈子内广为人知，专门开发用于处理、解释和利用数据的分析软件。赛仕也将自己视为一家人工智能公司，不过这里的人工智能更多是指主要使用量化方法的“经典人工智能”，而非大语言模型。许多德国公司都配备了赛仕的解决方案，例如德国信贷银行和巴门尼亚保险公司。在发布信息时，赛仕从产品创新百宝箱中拿出了很多东西：其中包括智能助手Copilot、数字孪生、合成数据生成、量子人工智能，当然还包括人工智能代理。
在赛仕帝国之外，围绕人工智能代理展开的竞赛也在飞快加速：开放人工智能研究中心(OpenAI)在1月份推出的研究预览版“操作员”(Operator)智能体引起了轰动——这是一款可以独立订票并填写表格的浏览器代理，未来将成为聊天生成预训练转换器(ChatGPT)付费服务的一部分。紧接着，OpenAI又推出了“深度研究”系统，这是一项集成到ChatGPT中的功能，可以自动完成需要数小时的互联网研究，并将其浓缩到几分钟内。谷歌计划在下周举行的2025年I/O开发者大会上披露有关阿丝特拉项目和“水手”项目的新细节。这两个项目都基于“双子座2.0”模型，并承诺将开发出可在工作区应用程序和开放网络中执行完整任务链的代理。
微软宣布其“语义内核”代理框架——这是一个用于开发人工智能代理的平台——已准备好在第一季度末投入使用，此外该公司还将推出用于处理Azure云服务平台中多代理工作流的“协调器”智能体。与此同时，“数据砖”公司在3月底开放了其“莫赛克”人工智能代理框架的普遍使用权。行业巨头们也在不断升级装备：西门子正在将其“工业副驾驶”人工智能产品系列扩展至自主制造代理；思爱普公司正在将人工智能代理“焦耳”深度嵌入复杂的业务流程；赛富时公司正在勾画一幅由“总代理”协调整个专业助手群的未来图景。
如果像赛仕这样谨慎的公司现在也押注人工智能代理，这应该引起人们的注意。赛仕开发的软件可以让这项技术更好地惠及来自高风险行业的客户，这些行业一直难以对其长年累月开发的结构进行现代化和自动化改造。为了让人工智能代理具备服务企业的能力，所需的方法不同于开发用于网络搜索和私人度假规划的人工智能代理。可靠性、安全性以及与公司流程的紧密集成在其中扮演着重要角色。
然而，赛仕才刚刚起步，现在必须在技术上兑现对客户的承诺。代理是赛仕开发的维亚数据和人工智能云平台的一个新组成部分，旨在将流程自动化提升到一个新水平。赛仕的客户可以将自己的自动化工作流程整合在一起，并将任意数量的内部流程串联——无论是利用大语言模型分析大型文档，还是利用经典定量方法进行数据分析。
这样一来，人工智能代理就能将现有流程和新流程整合为自动化工作流程。这听起来没有OpenAI的人工智能代理那么神秘。迄今为止，人们对OpenAI人工智能代理的结构知之甚少。但对于赛仕的客户来说，这也不该是神秘的——毕竟，从银行到保险公司和政府，许多高风险领域都在使用该软件，而不是“仅仅”把它用作旅行规划。
在自己的维亚平台上，赛仕希望在创新技术和最大限度地保障客户的安全之间取得平衡。无论赛仕公司如何创新，其核心仍然坚持“经典”人工智能的旧模式，并利用新的语言模型在各方面对其加以改进。然而，保守的战略也意味着赛仕在一定程度上落后于竞争对手。赛仕在2016年才推出自己的云平台，而谷歌、亚马逊和当时的初创公司“数据砖”彼时早已布局云端。虽然赛仕没有透露其云平台实际用户数量的相关数据，但最近该领域的销售额增长率有所下降。2023年，维亚平台的销售额与前一年相比增长了30%。2024年，增长率仅为24%。
赛仕公司一直由创始人兼首席执行官古德奈特领导，82岁的他已经是领导层中最老的成员之一。他认为生成式人工智能“被炒作过头了”，更倾向于使用久经考验的经典人工智能方法进行数据分析。他认为语言模型在编程方面做得“还行”，但目前还无法取代专业开发人员。
市场调研机构高德纳咨询公司预计，到2028年，三分之一的公司应用程序将包含基于代理的功能。这一次，赛仕的尝试并非跟风行为，而是传递了一个信号：当注重“安全第一”的先驱也在为人工智能代理开放平台时，新常态已经形成。（编译/宋羽豪）",科技 # 人工智能 # 商业,8,2653,8,2661,https://www.cankaoxiaoxi.com/#/detailsPage/kejiyy/2859ef54b57743e4942cf03668a625df/1/2025-06-19%2016:40?childrenAlias=undefined
49,"参考消息网6月19日报道 西班牙《趣味》月刊网站5月14日发表克里斯蒂安·佩雷斯的文章《史上第一支疫苗的诞生：1796年5月14日，一头牛、一个男孩与改变世界的乡村医生的真实传奇》，内容编译如下：
在英国格洛斯特郡腹地的伯克利小镇，乡村医生爱德华·詹纳在1796年5月14日这天完成了一项壮举。当天花仍是死亡与毁容代名词的时代，詹纳决定验证一个被视作农夫谣传的理论：感染牛痘(一种牛的良性传染病)者不会感染天花。
牛痘会使挤奶工接触感染奶牛乳房部位的皮肤产生小病灶。与留下恐怖疤痕、致死率达30%的天花不同，牛痘通常仅引发低烧和单个水疱便痊愈。乡间流传着挤奶女工因接触牛痘而免受“斑点恶魔”侵袭、拥有光洁脸庞的传说。
詹纳不满足于传闻。1796年5月14日，这位师从传奇外科医生约翰·亨特的学者，以精准手法将挤奶女工莎拉·内尔姆斯手上的牛痘脓液接种到8岁男孩詹姆斯·菲普斯的手臂上。男孩仅出现轻微发热后迅速康复。六周后决定性时刻到来：詹纳为其接种了天花疫苗，而詹姆斯安然无恙。疫苗就此诞生。
18世纪时，预防天花的理念并非新事物。早在数个世纪前，亚非地区就流行“人痘接种”，即将轻型天花患者的感染物质植入健康者体内。这项技术经英国驻君士坦丁堡大使夫人玛丽·沃特利·蒙塔古等人引入欧洲，1721年她在土耳其目睹该实践后将其带回伦敦，连皇室成员也曾接受人痘接种。
人痘接种虽比自然感染安全，但仍存在2%的致死风险，更可能引发新传染链，堪称一种医疗上的俄罗斯轮盘赌。詹纳发现的牛痘疫苗则提供了绝对安全的防护方案。牛痘疫苗可以提供防护，但不会造成感染天花的危险。
詹纳的发现远不止科学突破。他拒绝为发明申请专利，而是向包括美洲殖民地在内的全球各地的医生无偿分发技术，哈佛大学教授本杰明·沃特豪斯在托马斯·杰斐逊总统的直接支持下引入了这项技术。
医学界最初对动物疾病能保护人类的理论充满怀疑。乔治·皮尔逊等学者试图复现实验时，因样本被天花污染反而引发新疫情，加剧了争议。
然而随着时间的推移，事实不言而喻。随着接种者免疫案例激增，1802年英国议会授予詹纳1万英镑奖金，5年后又追加2万英镑。荣誉背后是个人悲剧：1815年詹纳的妻子因结核病去世后，詹纳逐渐退出公众视野。
晚年，詹纳继续在自家花园的一间小木屋里免费为人们接种疫苗，他把这间小木屋命名为“疫苗圣殿”。在那里，在鸟儿和书籍的包围中，这位改变了医学进程的乡村医生继续做着他最擅长的事情：挽救生命。
詹纳的发现让天花从全球瘟疫变成能被根除的人类疾病。1978年英国出现最后一例天花致命病例后，全球消灭天花认证委员会于1979年12月9日宣布该病已在世界范围内被消灭。1980年5月，第三十三届世界卫生大会正式宣告“全世界及全世界人民已摆脱了天花威胁”。
如果没有詹纳，人类历史将是另一番景象。他的工作为路易·巴斯德奠定基础，后者为致敬詹纳首创“疫苗”术语，并开创现代微生物学。如今亿万民众接种的麻疹、脊髓灰质炎、狂犬病、破伤风及新冠等疫苗，都源自1796年5月14日那个挤奶女工的手、八岁男孩的臂膀，和一位拒绝盲信、坚持实证的乡村医生。（编译/韩超）",健康 # 科技 # 社会,10,2035,11,2046,https://www.cankaoxiaoxi.com/#/detailsPage/kejiyy/e45b18eff2634ebab8bb844fb63a9ba2/1/2025-06-19%2016:40?childrenAlias=undefined
50,"参考消息网6月18日报道 美国趣味科学网站5月12日发表弗·麦克杜格尔的文章《行星真的能发展出大脑吗？》，内容编译如下：
如果我们的整个星球都有了意识呢？人类发现自己登上了一艘穿越浩瀚银河系的“飞船”——“地球飞船”，亨利·乔治、肯尼斯·博尔丁、巴克敏斯特·富勒等人就是如此贴切地描述它的。但这些思想家使用这个短语的结果却是，将人类社会限制在一个相对封闭、稳定的系统内。
如果“地球飞船”本身正发展出一个单一的新兴意识呢(实际上支撑这种意识的大部分基础设施已就位)？我把这个想法称为“盖亚大脑假说”，以致敬詹姆斯·洛夫洛克、琳恩·马古利斯等人提出的“盖亚假说”。他们认为，紧密相连的地球环境系统可被视作单一有机体。
我认为，与“地球飞船”有关的两种现象——首先是我们开始经历的全球环境破坏，其次是行星发展出大脑——是同一过程的两面。这个过程是令地球生命变得日渐复杂的自然循环的一部分，其将以出现一个能够协调地球“身体”、由全球人工智能驱动的“大脑”告终。
行星真的能发展出大脑吗？这样的结果可取吗？如果答案是否定的，我们能加以阻止吗？我并不是在预测未来，而是指出可能性罢了。我的观点是，如果我们足够幸运、勤奋和聪明，地球可能会产生一种新兴超意识。
“行星大脑”这个词乍听或许很古怪。因此，许多读者可能会对此产生误解。“也许作者的意思是，地球拥有环环相扣的系统——气候系统、生态系统、生物物理系统——这些系统可以被视作‘大脑’，或者比作‘心灵’。”但是，并非如此。让我们划去任何可能造成混淆的东西：我说的是一个新兴神经网络的生长——其整体并非由人类设计，即便其最初的组成部分确实是由人类设计的。
这个神经网络可以让地球实现大规模的意识统一。
这种新的思维在有形的、物理层面上由什么东西组成？微芯片、电路、超导体和半导体、数字存储设备、光纤电缆，最终还有量子计算机——电子处理器和通信设备。换言之，行星的思维和产生它的大脑将从地球科学家彼得·哈夫口中的“技术领域”出现。“技术领域”是我们为自己创造更紧密连通世界而制造出的百宝箱。
如果真的出现“行星大脑”，则很可能来自由人工智能增强的人造机构：技术先进的公司以及监管它们的政府，或是被我们统称为“后工业经济”的东西，它们本身就越来越自动化。
但是，这些相互关联的系统以及它们所代表的惊人的信息处理潜力，都是根据一种内在的全球逻辑运作的。因此，高科技与全球人类机构(包括但不限于跨国公司、联合国以及跨国社会运动)之间存在天然的标量协同作用。网络的范围越广，能力就越强。这些系统如果广泛、快速到了一定程度，最终可能会像大脑一样协同运作。在人类大脑中，有时逻辑会与“直觉”发生冲突，或者新思路与既定计划产生冲突。就像人类大脑一样，“盖亚大脑”所做的决定几乎都是讨论、冲突和各个构成要素之间相互妥协所达成的调解之道。
行星思维的出现并不是地球生命复杂性的首次激进标量升级。事实上，我们有不少于四个先例，可以从中窥见一般模式。之前的所有升级均建立在其前身的标量单位上。它们都从根本上提高了生命驾驭和使用能量的能力——换言之，就是熵的能力。
这些熵最大化的过程在扩张和集中、增长和协调之间循环往复。成功的部分开始领先于其他部分，但最终随着后者越来越少，两者之间最终建立起更加互利共生的关系。
互利共生产生了等级森严的集体。但这些集体是庞大笨拙的；它们需要形成集中的信息处理部门来进行中和，以协调其众多功能。成功发展出协调机制的集体才能繁荣发展。这样一来，一个全新的高阶单位就出现了。
人类从生物学角度对地球的前三次升级进行了研究。这三次升级包括原核生物、真核生物和智慧的多细胞生物分别出现。人类从社会学角度研究了此类升级中的第四次，其涉及作为大规模协同资源开发者的中央集权国家的出现。
就像多细胞生物的大脑一样，维持“地球大脑”将耗费大量能量。但它也可能带来巨大的回报，让地球设法找到新的能量来源，同时对可以处理废弃能源(热量)的内部功能进行调控。虽然人类设计的组织形式(至少在最初)会为基本结构设定参数，但它很可能会迅速演变。其快速解读海量信息、识别和预测可能出现的问题、找到最佳解决方案以及采取适当行动的能力将远超人类机构。
在“盖亚大脑”的设定下，至少有几个问题摆在我们面前。首先，地球是否拥有足够的资源来供养一个“行星大脑”？大脑一般是能量密集器官。“盖亚大脑”虽说是新生事物，但会给“行星身体”带来极大负担，这一点已经是板上钉钉的。
与较小行星相比，较大行星可能更易支撑“行星大脑”的发展。我们是否拥有必要的生物资本来支持“行星大脑”发展？还是说它的发展代价实在太过高昂，会令地球再次退回无脑状态？
其次，我们是否可以采取更明智的政策来促成“盖亚大脑”的发展？
第三，如果我们真的成功创造出一个“行星大脑”，人类的日常生活会变成什么样子？人类会成为这个大脑的一部分吗？还是说我们会集体失业？新出现的行星智能是否会对人类发展不利？我们的自由意志会被这个潜在的暴君完全压制吗？
最后，“行星大脑”的出现对我们理解宇宙以及人类在宇宙中的位置有什么影响？
我无法肯定我所描述的事情一定会发生，甚至不能说这在统计学上是可能的。
但这一论点确实有可能指引我们的政策行动，令这条道路更有可能实现。如此看来，它或许是一个自我实现的预言。它相当重要，值得我们注意，可能还值得我们共同努力：时间或许会证实，它比可预见的替代方案更可取。（编译/文怡）",科技 # 环境 # 哲学 # 未来学,9,2863,16,2879,https://www.cankaoxiaoxi.com/#/detailsPage/kejiyy/beac72cbbe5d4b63a4cce82f05791ef1/1/2025-06-18%2016:35?childrenAlias=undefined
51,"参考消息网6月19日报道 参考智库与世研指数日前联合发布“中国省级文旅海外社交媒体传播力指数（2025年5月号）”。本指数以2025年5月1日至5月31日为监测周期。数据覆盖范围为5个海外社交媒体平台：脸书（Facebook）、X平台、照片墙（Instagram），视频平台YouTube和TikTok。
截至统计日，中国省级文旅机构在上述平台开设账号并处于运营状态的数量如下：脸书24个、X平台24个、照片墙25个、视频平台23个。
总体而言，本监测周期内，中国省级文旅海外社交媒体账号通过创新议题设置与体系化传播布局，进一步提升国际传播效能。其中，部分省级文旅账号积极策划话题性活动，注重对本地特色景观和文化的宣推，重视与海外受众互动，强化国际化表达，打造海外社交媒体传播矩阵，持续提升省级文旅海外影响力。
中国省级文旅海外社交媒体传播力指数TOP20总览（2025年5月）
一、总体情况
在综合传播力方面，排序前二十的中国省级文旅账号为：江苏省、北京市、山东省、江西省、辽宁省、安徽省、吉林省、新疆维吾尔自治区、甘肃省、重庆市、云南省、上海市、广西壮族自治区、陕西省、四川省、浙江省、福建省、内蒙古自治区、贵州省、河南省。
中国省级文旅海外社交媒体综合传播力指数TOP20（2025年5月）
与上一监测周期相比，排序相对靠前的中国省级文旅账号差异不大，“第一梯队”中仅个别省级文旅账号排序出现微调。
本监测周期，山东省在综合传播力指数中表现优异。山东文旅以情景交融的方式将节日话题、季节现象与地方旅游资源相结合，在海外社交媒体发布具有视觉冲击力的图文网帖，吸引海外网友关注与互动。如5月28日，其脸书账号发布了一组烟台市17号公路沿线照片，一边是大海，一边是城市，配以优美的文案并介绍公共交通游览方法。截至统计日，该网帖获超2.6万次点赞。又如5月11日母亲节当天，其X平台账号发布了一组花海搭配建筑、列车的照片，以充满浪漫气息的图文向亲爱的母亲们致敬。截至统计日，该网帖获得超23万次浏览量、3134次点赞，为提升山东文旅海外美誉度提供了有效助力。
山东文旅脸书、X平台账号相关网帖截图
二、各海外社交媒体传播力情况
（一）中国省级文旅脸书传播力指数
2025年5月，中国省级文旅脸书传播力指数排序前二十的是：江苏省、山东省、北京市、甘肃省、江西省、安徽省、辽宁省、浙江省、贵州省、新疆维吾尔自治区、重庆市、吉林省、陕西省、内蒙古自治区、四川省、云南省、上海市、河南省、黑龙江省、福建省。
中国省级文旅脸书传播力指数TOP20（2025年5月）
本监测周期，甘肃文旅在上述维度中表现优异。在策略应用方面，甘肃文旅以国际性节日为契机，宣传本土文化，讲述地域故事，吸引众多海外网友参与互动，提升甘肃旅游吸引力。
如5月1日国际劳动节，甘肃文旅发布了一则图文网帖，向每一位辛勤劳动的人致敬，并邀请全世界劳动者到甘肃来探寻古老的壁画，聆听丝绸之路的回响，感受多元文化的魅力。截至统计日，该网帖获超3.8万次点赞。
甘肃文旅脸书账号相关网帖截图
（二）中国省级文旅X平台传播力指数
2025年5月，中国省级文旅X平台传播力指数排序前二十的是：北京市、江苏省、江西省、辽宁省、山东省、甘肃省、安徽省、吉林省、四川省、新疆维吾尔自治区、陕西省、广西壮族自治区、云南省、浙江省、内蒙古自治区、重庆市、福建省、河南省、贵州省、上海市。
中国省级文旅X平台传播力指数TOP20（2025年5月）
本监测周期，吉林文旅在本维度有不错的表现。在策略应用方面，吉林文旅以地方生态文化资源为依托，推动文化与旅游深度结合，打造文旅IP，拓宽品牌旅游传播辐射广度，提升海外知名度和影响力。如5月8日吉林文旅发布了一组精美的图片，在令人心驰神往的意境中展现出长白山原始、自然的风光。截至统计日，该网帖获超1200次浏览量。长白山作为文化地标已成为吉林文旅的“金字招牌”，对提升其海外形象辨识度形成支撑。
吉林文旅X平台账号相关网帖截图
（三）中国省级文旅照片墙传播力指数
2025年5月，中国省级文旅照片墙传播力指数排序前二十的是：山东省、北京市、安徽省、江苏省、江西省、甘肃省、辽宁省、吉林省、新疆维吾尔自治区、广西壮族自治区、宁夏回族自治区、陕西省、浙江省、重庆市、贵州省、内蒙古自治区、上海市、四川省、福建省、黑龙江省。
中国省级文旅照片墙传播力指数TOP20（2025年5月）
本监测周期，广西文旅在上述维度中表现突出，其排序相较上一监测周期上升两位。在策略应用方面，广西文旅主动策划文旅活动，讲述当地文旅故事，释放地方文旅活力，创新海外社交媒体表达方式，助推地方文旅品牌建设和海外形象传播。
2025年，广西依托丰富的旅游资源，推出为时一年的“广西旅游年”活动，以扩大广西旅游品牌影响力和知名度。5月13日，广西文旅账号发布了一则视频，以快闪的方式展示广西的地标性景点，吸引海内外游客前来。截至统计日，该网贴获超1.6万次点赞。
广西文旅照片墙账号相关网帖截图
（四）中国省级文旅视频平台传播力指数
2025年5月，中国省级文旅视频平台传播力指数排序前二十的是：江苏省、江西省、北京市、辽宁省、山东省、安徽省、新疆维吾尔自治区、云南省、吉林省、上海市、重庆市、广西壮族自治区、西藏自治区、福建省、陕西省、甘肃省、四川省、宁夏回族自治区、河南省、河北省。
中国省级文旅视频平台传播力指数TOP20（2025年5月）
本监测周期，辽宁文旅在上述维度中的表现可圈可点。在策略应用方面，辽宁文旅以少数民族饮食文化为切入点，讲述民族文化和地方文化，激发海外受众好奇心，实现跨文化对话，从而增强海外受众对其海外形象的认同感。
如5月13日，辽宁文旅账号发布了一则视频，展现了鸭绿江边的丹东振安特色朝鲜族美食盛宴，视频充满视觉冲击力与风味展现力。截至统计日，该视频观看量超过2.4万次，有利于强化辽宁海外形象中的“民族特色”文化标签。
辽宁文旅视频账号相关网帖截图
三、研究说明
“中国省级文旅海外社交媒体传播力指数”以中国各省、直辖市、自治区文旅厅（局）在海外社交媒体平台上开设的官方账号为指数评估主体，依据其在不同海外社交媒体平台上的多维度传播数据，通过指数模型运算，实现对中国省级文旅海外社交媒体传播力的指数得分。根据各平台的全球用户规模、活跃度、影响力相关度等因素动态设定平台权重，各平台指数加权计算形成综合传播力指数。中国省级文旅海外社交媒体传播力指数体系算法包括定性与定量两部分。其中，定量指标权重占比80%，定性指标权重占比20%。
研究说明 制图：世研指数
本指数的数据获取方式为：将各省、直辖市、自治区文旅厅（局）在海外社交媒体平台上开设的官方账号纳入大数据监测系统，获取该官方账号的传播月度数据，包括但不限于内容创作数据（Generate）；互动交流数据（Interactive），包括分享、评论和认可等行为动作所产生的数据；用户享用信息数据（Utilize），包括订阅/关注、浏览等行为动作所产生的数据。指数模型设计及制图由世研指数提供。
课题组成员：
参考智库：张诚、张陆煜、崇珅、张威威、李倩
世研指数：刘志明、徐善水、刘洋、马文凤、支春云",旅游 # 文化 # 社交媒体 # 国际传播 # 品牌建设,9,3812,21,3833,https://www.cankaoxiaoxi.com/#/detailsPage/cankaozk/5db92330bee144e08e83e5dbaf69f7a9/1/2025-06-19%2014:43?childrenAlias=undefined
52,"参考消息网6月19日报道 参考智库与世研指数日前联合发布“中国省级文旅海外社交媒体传播力指数（2025年5月号）”。本指数以2025年5月1日至5月31日为监测周期。数据覆盖范围为5个海外社交媒体平台：脸书（Facebook）、X平台、照片墙（Instagram），视频平台YouTube和TikTok。
截至统计日，中国省级文旅机构在上述平台开设账号并处于运营状态的数量如下：脸书24个、X平台24个、照片墙25个、视频平台23个。
总体而言，本监测周期内，中国省级文旅海外社交媒体账号通过创新议题设置与体系化传播布局，进一步提升国际传播效能。其中，部分省级文旅账号积极策划话题性活动，注重对本地特色景观和文化的宣推，重视与海外受众互动，强化国际化表达，打造海外社交媒体传播矩阵，持续提升省级文旅海外影响力。
中国省级文旅海外社交媒体传播力指数TOP20总览（2025年5月）
一、总体情况
在综合传播力方面，排序前二十的中国省级文旅账号为：江苏省、北京市、山东省、江西省、辽宁省、安徽省、吉林省、新疆维吾尔自治区、甘肃省、重庆市、云南省、上海市、广西壮族自治区、陕西省、四川省、浙江省、福建省、内蒙古自治区、贵州省、河南省。
中国省级文旅海外社交媒体综合传播力指数TOP20（2025年5月）
与上一监测周期相比，排序相对靠前的中国省级文旅账号差异不大，“第一梯队”中仅个别省级文旅账号排序出现微调。
本监测周期，山东省在综合传播力指数中表现优异。山东文旅以情景交融的方式将节日话题、季节现象与地方旅游资源相结合，在海外社交媒体发布具有视觉冲击力的图文网帖，吸引海外网友关注与互动。如5月28日，其脸书账号发布了一组烟台市17号公路沿线照片，一边是大海，一边是城市，配以优美的文案并介绍公共交通游览方法。截至统计日，该网帖获超2.6万次点赞。又如5月11日母亲节当天，其X平台账号发布了一组花海搭配建筑、列车的照片，以充满浪漫气息的图文向亲爱的母亲们致敬。截至统计日，该网帖获得超23万次浏览量、3134次点赞，为提升山东文旅海外美誉度提供了有效助力。
山东文旅脸书、X平台账号相关网帖截图
二、各海外社交媒体传播力情况
（一）中国省级文旅脸书传播力指数
2025年5月，中国省级文旅脸书传播力指数排序前二十的是：江苏省、山东省、北京市、甘肃省、江西省、安徽省、辽宁省、浙江省、贵州省、新疆维吾尔自治区、重庆市、吉林省、陕西省、内蒙古自治区、四川省、云南省、上海市、河南省、黑龙江省、福建省。
中国省级文旅脸书传播力指数TOP20（2025年5月）
本监测周期，甘肃文旅在上述维度中表现优异。在策略应用方面，甘肃文旅以国际性节日为契机，宣传本土文化，讲述地域故事，吸引众多海外网友参与互动，提升甘肃旅游吸引力。
如5月1日国际劳动节，甘肃文旅发布了一则图文网帖，向每一位辛勤劳动的人致敬，并邀请全世界劳动者到甘肃来探寻古老的壁画，聆听丝绸之路的回响，感受多元文化的魅力。截至统计日，该网帖获超3.8万次点赞。
甘肃文旅脸书账号相关网帖截图
（二）中国省级文旅X平台传播力指数
2025年5月，中国省级文旅X平台传播力指数排序前二十的是：北京市、江苏省、江西省、辽宁省、山东省、甘肃省、安徽省、吉林省、四川省、新疆维吾尔自治区、陕西省、广西壮族自治区、云南省、浙江省、内蒙古自治区、重庆市、福建省、河南省、贵州省、上海市。
中国省级文旅X平台传播力指数TOP20（2025年5月）
本监测周期，吉林文旅在本维度有不错的表现。在策略应用方面，吉林文旅以地方生态文化资源为依托，推动文化与旅游深度结合，打造文旅IP，拓宽品牌旅游传播辐射广度，提升海外知名度和影响力。如5月8日吉林文旅发布了一组精美的图片，在令人心驰神往的意境中展现出长白山原始、自然的风光。截至统计日，该网帖获超1200次浏览量。长白山作为文化地标已成为吉林文旅的“金字招牌”，对提升其海外形象辨识度形成支撑。
吉林文旅X平台账号相关网帖截图
（三）中国省级文旅照片墙传播力指数
2025年5月，中国省级文旅照片墙传播力指数排序前二十的是：山东省、北京市、安徽省、江苏省、江西省、甘肃省、辽宁省、吉林省、新疆维吾尔自治区、广西壮族自治区、宁夏回族自治区、陕西省、浙江省、重庆市、贵州省、内蒙古自治区、上海市、四川省、福建省、黑龙江省。
中国省级文旅照片墙传播力指数TOP20（2025年5月）
本监测周期，广西文旅在上述维度中表现突出，其排序相较上一监测周期上升两位。在策略应用方面，广西文旅主动策划文旅活动，讲述当地文旅故事，释放地方文旅活力，创新海外社交媒体表达方式，助推地方文旅品牌建设和海外形象传播。
2025年，广西依托丰富的旅游资源，推出为时一年的“广西旅游年”活动，以扩大广西旅游品牌影响力和知名度。5月13日，广西文旅账号发布了一则视频，以快闪的方式展示广西的地标性景点，吸引海内外游客前来。截至统计日，该网贴获超1.6万次点赞。
广西文旅照片墙账号相关网帖截图
（四）中国省级文旅视频平台传播力指数
2025年5月，中国省级文旅视频平台传播力指数排序前二十的是：江苏省、江西省、北京市、辽宁省、山东省、安徽省、新疆维吾尔自治区、云南省、吉林省、上海市、重庆市、广西壮族自治区、西藏自治区、福建省、陕西省、甘肃省、四川省、宁夏回族自治区、河南省、河北省。
中国省级文旅视频平台传播力指数TOP20（2025年5月）
本监测周期，辽宁文旅在上述维度中的表现可圈可点。在策略应用方面，辽宁文旅以少数民族饮食文化为切入点，讲述民族文化和地方文化，激发海外受众好奇心，实现跨文化对话，从而增强海外受众对其海外形象的认同感。
如5月13日，辽宁文旅账号发布了一则视频，展现了鸭绿江边的丹东振安特色朝鲜族美食盛宴，视频充满视觉冲击力与风味展现力。截至统计日，该视频观看量超过2.4万次，有利于强化辽宁海外形象中的“民族特色”文化标签。
辽宁文旅视频账号相关网帖截图
三、研究说明
“中国省级文旅海外社交媒体传播力指数”以中国各省、直辖市、自治区文旅厅（局）在海外社交媒体平台上开设的官方账号为指数评估主体，依据其在不同海外社交媒体平台上的多维度传播数据，通过指数模型运算，实现对中国省级文旅海外社交媒体传播力的指数得分。根据各平台的全球用户规模、活跃度、影响力相关度等因素动态设定平台权重，各平台指数加权计算形成综合传播力指数。中国省级文旅海外社交媒体传播力指数体系算法包括定性与定量两部分。其中，定量指标权重占比80%，定性指标权重占比20%。
研究说明 制图：世研指数
本指数的数据获取方式为：将各省、直辖市、自治区文旅厅（局）在海外社交媒体平台上开设的官方账号纳入大数据监测系统，获取该官方账号的传播月度数据，包括但不限于内容创作数据（Generate）；互动交流数据（Interactive），包括分享、评论和认可等行为动作所产生的数据；用户享用信息数据（Utilize），包括订阅/关注、浏览等行为动作所产生的数据。指数模型设计及制图由世研指数提供。
课题组成员：
参考智库：张诚、张陆煜、崇珅、张威威、李倩
世研指数：刘志明、徐善水、刘洋、马文凤、支春云",#旅游 #文化 #社交媒体 #国际传播 #中国省级文旅,9,3805,14,3819,https://www.cankaoxiaoxi.com/#/detailsPage/cankaozk/5db92330bee144e08e83e5dbaf69f7a9/1/2025-06-19%2014:43?childrenAlias=undefined
53,"参考消息网6月18日报道 参考消息报社参考智库日前发布《中国百城海外传播力月度分析报告（2025年5月号）》。
本报告以2025年5月1日至5月31日为监测周期，监测对象涵盖包括直辖市、省会城市、副省级城市、特色城市、边境城市等（不含港澳台）在内的100个中国城市。
总体来看，本监测周期，城市议题设置呈现多元化特征，涉及时政、经贸、科技、文化等多领域，主动贴合国际热点且“自塑”比重增强，同时传播媒介趋于多样化，城市国际舆论引导力和影响力显著提升。
具体而言，一是国际性活动的密集举办增加城市在海外媒体中的曝光频率，强化国际化链接和城市知名度；二是国际间经贸合作往来既有利于激发中外经济活力，也成为城市品牌在国际间高效传播的途径之一；三是科技发展尤其是人工智能动态是国际舆论场的热门前沿话题，可有效提振相关城市海外影响力和美誉度；四是国际体育赛事可吸引全球相关领域粉丝和媒体关注，不仅成为主办城市进行跨文化传播的重要平台，也成为城市文化和形象对外传播的重要契机。此外，本监测周期恰逢中国传统节日端午节，相关民俗活动在多个城市集中呈现，在海外传统媒体和海外社交媒体都形成一定的话题性，带来一波涉中国传统文化的正向舆情，为相关城市提升海外影响力和辨识度提供助力。
一、总体情况
中国百城海外传播力月度指数由海外传播度和海外美誉度两个一级指标构成，旨在对中国城市国际传播的综合影响力进行评估。本监测周期内，海外影响力月度指数排序前20的城市涵盖东中西部地区，沿海城市较多。在传播策略方面，排序相对靠前的城市总体呈现出经济发展动能强劲的特点，以成都为代表的主动传播意识较强的城市在议题设置能力方面趋于成熟，在国际传播效能上，正逐渐从让海外受众“听得到”向“听进去”“想进来”转变。
▲海外影响力月度指数前20
具体情况如下：
一是高频举办国际性活动，如论坛、博览会、展会、交易会等，是城市硬实力和软实力的双重展现，其在履行了一系列外交、经济、文化交流等使命的同时，无形中对建构多元立体的中华文化国际传播话语体系形成助力。如5月29日，世界市长对话·上海暨2025年上海国际友好城市合作论坛开幕，来自22个国家的26个友城代表团约100位嘉宾出席。又如5月22日至26日，第二十一届中国(深圳)国际文化产业博览交易会举行，来自110个国家和地区的共3.5万余名海外专业观众线上线下参会。再如，5月22日至25日，第四届中国—中东欧国家博览会暨国际消费品博览会在宁波举办，为增进中国市场对中东欧商品的了解、凝聚中国—中东欧国家合作共识等发挥了重要作用。
国际性的外交、经济、文化活动等，为相关城市推进高水平对外开放创造契机，有利于其加速国际化进程，提升城市海外影响力。
二是国际经贸合作是开展国际传播的天然沃土，经贸的辐射链条与国际传播广度可实现同频共振。如5月23日，“中国（重庆）—阿联酋经贸投资推介会”在重庆举行，推介会促成了涵盖产业、商贸、物流、教育等多项具体合作。又如在5月27日举行的2025海丝港口合作论坛开幕式暨主论坛上，宁波舟山港分别与欧洲三大枢纽港——德国汉堡港、威廉港和西班牙瓦伦西亚港签署绿色航运走廊建设协议，计划建设三条绿色航运走廊，助推中欧港口深化低碳合作。再如5月20日，全球知名会员制仓储零售品牌山姆会员店在华北地区规模最大门店在天津举行启动仪式，彰显其持续深耕中国市场的决心。国际经贸往来发挥着纽带桥梁作用，助推城市提升国际传播效能。
三是以人工智能为代表的前沿科技成果是时下国际舆论场的热门话题，相关议题往往吸引外媒对相关城市的探访与聚焦。5月25日，以人形机器人为参赛主体的格斗竞技赛事在杭州开幕，展示了中国机器人科技的最新突破。杭州作为“AI创新之城”备受外媒和国际行业人士关注，有利于强化杭州海外形象中的“科技”标签。
四是国际性体育赛事是跨文化传播的极佳推手之一，在全球粉丝群中形成线上线下链条式传播，助力提升主办城市的海外知名度。如2025年世界田联接力赛5月10日至11日在广州举行，该届赛事是世界田联接力赛创办11年来首次在中国举办。又如5月24日晚，首届亚足联女足俱乐部冠军联赛决赛在武汉举行。国际顶级体育赛事作为战略性传播平台，为城市开展国际叙事提供了多维度的表达空间。通过赛事筹备、举办和后续运营的全周期传播设计，有利于城市有机整合竞技精神、文化展示和科技创新等叙事要素，构建具有全球共鸣性的中国故事体系。
此外，本监测周期恰逢中国传统节日——端午节，广州、成都、杭州、佛山、苏州等地举行了龙舟比赛和各式各样的非遗庆祝活动，浓郁的民俗气息吸引海内外游客到访，在海外社交媒体上形成一定话题热度，为城市文化IP打造形成助力，进一步强化了海外受众对城市形象的认同感。
二、海外传播度
在海外传播度指标方面，排序前20的城市与海外影响力前20的城市基本一致。其中，北京领先优势明显，上海、深圳、广州、成都、南京、武汉、杭州、天津等多个城市亦有突出表现。
▲海外传播度月度指数前20
本监测周期，国际性活动和国际间交流合作相关议题较集中，在境外传统媒体和海外社交媒体中均有热点话题产生，有效提升相关城市国际传播效能。在海外传播度排序前20的城市中，北京、上海、深圳、广州、成都、杭州6座城市表现抢眼，同时进入媒体关注指数和海媒关注指数两个二级指标排序前列。
上述城市将国际性活动与本土产经文化优势相结合，传播效果较为明显。其反映在媒体关注指数下辖的海外媒体发稿量、海外媒体覆盖国家量、海外媒体覆盖语种数量、海外媒体家数、海外主流媒体发稿量5个三级指标中，北京、上海、深圳、广州等城市以较明显的优势居于领先地位。
▲媒体关注指数前20
▲海媒关注指数前20
（一）媒体关注指数
本监测周期，科技动态助推杭州国际影响力的提升，其在媒体关注指数中表现较好。
5月25日，以人形机器人为参赛主体的格斗竞技赛事在杭州举行，引发境外媒体集中关注。路透社、美国在线公司、欧洲新闻台、《西班牙人报》网站、“法国24小时”网站、阿根廷布宜诺斯艾利斯经济新闻网、韩国《中央日报》、香港《南华早报》、台湾中时新闻网、菲律宾《马尼拉时报》等媒体成为主要信源和传播主体，报道基调积极正向。
如《西班牙人报》网站报道称：“中国举办了首届G1人形机器人拳击锦标赛，并在X平台进行了直播。此次赛事在浙江省杭州市举行，机器人展示了各种动作，包括拳击、勾拳、踢腿，甚至摔倒后还能站起来。”
▲《西班牙人报》网站相关报道截图
阿根廷布宜诺斯艾利斯经济新闻网则报道称：“四个人形机器人在中国东部城市杭州的拳击场上展开决斗，这一幕让人联想到未来主义电影。”该媒体认为，该赛事被认为是一个展示平台，展示中国在人工智能、生物力学和运动控制方面的进步。通过这样的展示，中国正在巩固其在类人机器人开发方面的领导地位。
▲布宜诺斯艾利斯经济新闻网相关报道截图
本轮传播中，在机器人格斗大赛相关报道中，杭州被频繁提及，有利于强化杭州海外形象中的“科技”标签。
（二）海媒关注指数
本监测周期内，海媒关注指数表现较为亮眼的城市为武汉，其在排序前20的城市中位列第三。值得注意的是，在海媒关注指数下辖的两个三级指标——点赞量和评论量上，武汉分别位列第五和第四。这些数据表明，武汉在海外社交媒体平台上获得了较高的关注。
▲点赞量
▲评论量
本监测周期，技术加持基础设施智能升级，武汉打造的科技感、未来感十足的现代化城市形象吸引海外受众关注。
同时，其发展速度之快令外国友人惊叹不已，尤其是在日常生活和城市角落里展现的科技含量，经常成为海外博主的热议话题。如在优兔平台，5月11日，账号名为“Homeless Pelican”的外国网友发布视频网帖：“在本视频中，我将探索武汉如今的面貌！这座中国城市闻名世界的原因众所周知——但那已是过去。今天，我将聚焦武汉如何蜕变为一座充满未来感的大都市。从令人叹为观止的创新，例如颠倒的地铁（单轨）、无人驾驶出租车、市中心的巨型3D屏幕，到沿途遇到的形形色色的人们——我感觉自己仿佛置身于一部科幻电影之中。”截至统计日，该网帖观看量超过23万次。
▲相关网帖截图
三、海外美誉度
在海外美誉度指标方面，排序前20的城市同海外传播度指标中前20的城市略有不同，北京、上海处于领先，其后是深圳、广州。
▲海外美誉度月度指数前20
宁德、郑州、大连、西安、洛阳五座城市有不错的表现，跻身海外美誉度前20。从海外形象指数和海媒评价指数两项二级指标看，宁德、郑州、大连、西安分别因企业动态、旅游贸易、国际展览、论坛展会方面的议题进入了海外形象指数前20，上述四城的积极海外形象传播主要来自传统媒体；而洛阳则主要得益于在社交媒体收获的积极形象，进而位列海媒评价指数前20。
本监测周期内，第九届丝绸之路国际博览会暨中国东西部合作与投资贸易洽谈会（以下简称丝博会）在西安开幕，对相关城市的国际曝光度和美誉度拉升效果明显。本届博览会以“丝路融通·开放合作”为主题，举办多场经贸投资交流活动，全面展现共建“一带一路”成果，促进国际经贸交流合作。文莱新闻网、俄罗斯《劳动报》、哈萨克斯坦《实业报》、巴基斯坦联合通讯社、韩国《中央日报》等境外媒体成为主要信源和传播主体。
俄罗斯《劳动报》发表题为《无人机成为西安丝绸之路展览的明星》的文章，并称：“中国西部地区，尤其是陕西和四川，正在积极推进这一发展方向。陕西已形成完整的飞机研发制造产业链。四川已建成涵盖飞机、机载系统、零部件和材料的产业链。该地区蓬勃发展的中大型无人机产业在全国处于领先地位。”
▲俄罗斯《劳动报》网站相关报道截图
在海外社交媒体平台，丝博会也吸引众多海外网友关注。如江苏X平台账号发布网帖：“第九届丝绸之路国际博览会于5月21日在西安拉开帷幕！为期五天的博览会吸引了来自尼泊尔、土耳其等40多个国家和地区的嘉宾。”截至统计日，该网帖浏览量达20万，收获点赞量518次。
▲江苏X平台账号截图
本监测周期，洛阳在海外社交媒体平台有较为亮眼的表现。如外交部发言人毛宁X平台账号发布内容为“河南洛阳——历史与工业力量的交融”的网帖。截至统计日，该网帖浏览量达3.7万，收获点赞量1018次。
▲毛宁X平台账号截图
此外，河南账号发布的多篇洛阳相关网帖，也收获不错的传播效果。如5月26日河南X平台账号Visit Henan发布的光与影结合视频网帖：“洛阳的魅力简直无与伦比！每一帧都堪称壁纸级的杰作。驻足片刻，一切烦恼都烟消云散。”截至统计日，该视频观看量超4.1万次。
▲相关网帖截图
四、研究说明
“中国百城海外传播力月度分析报告”以中国城市在海外主流媒体及社交媒体中的传播效果为主要评估方向，下设两个一级维度：海外传播度和海外美誉度。
海外传播度设有两个二级指标：媒体关注指数及海媒关注指数，并包括海外媒体发稿量、海外媒体覆盖国家量、海外媒体覆盖语种数量、海外媒体家数、海外主流媒体发稿量、点赞量、评论量、分享量及社交媒体覆盖语种数量等三级指标。
海外美誉度同样设有两个二级指标：海外形象指数及海媒评价指数，并包括正面舆情发稿被转载（转引）量、正面舆情发稿被海外主流媒体转载（转引）量、海外媒体正面舆情发稿量、海外媒体正面舆情发稿量占全部稿件量比例、正面发帖数量以及正面发帖占所有发帖数量比例等三级指标。
本报告通过对各维度、指标数据进行加权、归一，得出研究结论。需要说明的是，定量分析的指标选择、模型搭建和参数设置，必然带有一定主观性，不同的指标选择和参数设置，很可能带来不同的定量结果。报告中使用定量分析的目的，是为了更加准确地展示中国城市海外传播关注度的具体情况，其分析结论并不具有“排名”结果，而是为外界提供更详实的参考作用。
五、关于我们
参考智库《中国百城海外传播力月度分析报告》依托参考消息海外舆情大数据库及信息监测系统，研究范围涵盖英文、俄文、法文、德文、西班牙文、葡萄牙文、日文、阿拉伯文等多个主要文种信源，覆盖上千家境外媒体及多个主要海外社交媒体平台，以海外关注度较高的100个中国城市（未含港澳台地区）的舆情数据为基础进行测算。旨在综合评估中国城市国际传播和国际品牌建设效果，为城市决策者、研究者提供国际传播领域的业务参考。
参考智库成立于2020年5月，是新华社国家高端智库成员单位，也是参考消息报社智库平台，拥有丰富的海外舆情资源和业内一流的海外舆情分析师队伍，通过人工智能、大数据等先进技术赋能，定期推出城市国际传播、海外舆情分析报告。参考智库连续发布《中国城市海外影响力分析报告》，为中国城市国际传播、打造城市软实力“问诊把脉”。",政治 # 国际 # 科技 # 体育 # 社会,9,6492,17,6509,https://www.cankaoxiaoxi.com/#/detailsPage/cankaozk/8ad0996794fd409bb63bf18856074cb1/1/2025-06-18%2009:33?childrenAlias=undefined
54,"参考消息网5月23日报道 参考智库与世研指数日前联合发布“中国城市海外社交媒体传播力指数（2025年4月号）”。本指数以2025年4月1日至30日为监测周期，以133个中国城市为监测目标，数据覆盖范围为5个海外社交媒体平台：脸书（Facebook）、X平台、照片墙（Instagram）、YouTube和TikTok。其中，TikTok传播力指数因城市账号数量较少，暂不列入综合排序。
本监测周期正值春暖花开、生机盎然的时节，中国各地迎来一波旅游高峰。各城市账号充分把握这一契机，围绕自然景观、人文历史、科技生活和文化体验等议题，持续开展精准化、差异化内容传播，输出优质内容，在海外社交媒体平台实现有效触达并引发积极互动。同时，凭借“原产地效应”的传播优势，中国城市特色创新实践通过社交化传播路径实现全球扩散，逐步形成国际舆论场中的热点话题，为塑造可信、可爱、可敬的中国形象提供了新的传播支点。
▲中国城市海外社交媒体传播力指数TOP10（制图：世研指数）
一、总体情况
在综合传播力方面，排序相对靠前的中国城市为：南京、北京、成都、杭州、重庆、苏州、厦门、沧州、西安、常州。
▲中国城市海外社交媒体综合传播力指数TOP10（制图：世研指数）
在跨文化传播场域中，多元化的内容生态与创新性的媒介呈现形式正日益成为触发海外受众深度参与的关键要素。通过差异化叙事策略与多媒体形态的有机融合，中国城市的国际传播内容不仅实现了传播广度的突破，更在认知维度上引发了海外受众的情感共鸣与价值认同，从而构建起更具持久性的传播影响力。
本监测周期，北京在综合传播力方面表现突出，展现出持续、稳定的国际传播能力。北京持续提升国际传播内容的多样化水平，不断丰富媒体表达方式，成为海外受众关注和热议的焦点之一。
一方面，北京将中国传统文化符号与现代交通基础设施的有机融合，在全球社交媒体平台引发跨文化传播效应。如4月21日，北京脸书账号发布地铁8号线与12号线中转枢纽安华桥站的站内设计图片，中国古典文化元素与现代交通设施的巧妙融合和对碰成为海外受众的热议话题。截至统计日，该网帖获赞10万次。
另一方面，科技创新正日益成为中国城市国际传播矩阵中的叙事支点。通过聚焦前沿领域，北京展现了高质量发展的实践路径，巩固了科技与人文交融的现代城市形象，为全球受众提供了观察中国式现代化的独特视角。如4月23日，北京X平台账号发布一组图片，展示中国科学技术馆的航天、AI、生物技术互动展览盛况。该网帖吸引大量海外受众参与互动与讨论，不仅进一步提升了北京在全球城市网络中的话题热度，更在认知维度强化了其作为国际化大都市的品牌影响力，为城市国际传播的效能提升提供了实证案例。
▲北京脸书、X平台账号截图
二、各海外社交媒体传播力情况
（一）中国城市脸书传播力指数
2025年4月，中国城市脸书传播力指数排序相对靠前的城市是：南京、北京、厦门、成都、青岛、沈阳、烟台、东营、济南、常州。
▲中国城市脸书传播力指数TOP10（制图：世研指数）
当前，系统性内容策划已成为提升国际传播影响力持续性的关键策略。本监测周期，成都应用上述策略，在中国城市脸书传播力指数中表现优异。其中，“Go Chengdu”账号4月共发布122条网帖，新增粉丝量过万；网帖总观看量达2627万，覆盖1409万人次，总互动量为46.8万，互动率达54%。单条数据最好帖文为非遗唢呐制作视频，其播放量为232万，互动量为3.1万，覆盖232万人次。“Chengdu Plus”账号总发帖量超150条，覆盖量超52万人次。
在操作层面，成都策划经济类系列议题，聚焦成都创新创造，共计发布《今日成都》（Chengdu Today）四期，策划推出《来成都旅游的N个理由》系列短视频、欧洲文化季、大熊猫系列，成都文旅相关短视频等，覆盖人数达数十万。通过主题化、系列化的深度报道架构，成都维持稳定的传播节奏，进一步构建多维度的叙事体系，在国际舆论场中形成长效的话题热度和认知渗透，为提升城市海外影响力形成支撑。
此外，文化节庆活动作为城市国际传播的柔性载体，通过贴近民众的文化叙事策略，能够有效构建起跨文化对话的公共空间。本监测周期，文昌应用该策略，传播效果良好。
在操作层面，文昌账号聚焦2025年第十一届海南文昌南洋文化节，发布探访马来西亚吉隆坡、文化节开幕式、开幕式烟花秀、马来西亚博主评述文化节、本地博主开幕式Vlog、文化节排球嘉年华等系列网帖。这种以文化认同为纽带、情感共鸣为路径的传播模式，不仅消解了传统外宣的刚性色彩，更通过沉浸式体验和参与式互动，在海外受众认知中植入具象化的城市形象符号，最终实现城市文化软实力的润物无声式输出。
（二）中国城市X平台传播力指数
2025年4月，中国城市X平台传播力指数排序相对靠前的城市是：北京、南京、厦门、烟台、沈阳、杭州、成都、宁波、无锡、福州。
▲中国城市X平台传播力指数TOP10（制图：世研指数）
城市标志性景观与艺术的创新性融合，能够建构多维度的感官传播体验，这种跨媒介叙事策略既有效消解了传播过程中的文化折扣，又通过情感化传播路径提升城市形象在海外受众中的识别度与美誉度。
本监测周期，厦门有效应用上述策略，所发布内容互动量达2.34万次，互动率达786，在中国城市X平台传播力指数中排序相对靠前。
在操作层面，如4月22日，厦门账号以#xiamen Beats为话题，以海浪和音乐的结合为出发点，配以美景图片，展示厦门旅游特色，形式颇具新意。从传播效果考量，这种艺术化的城市形象呈现方式，不仅突破了语言、文化的传播壁垒，更在符号学层面完成了城市文化资本向城市国际形象的转译，为城市国际传播提供了新路径。
▲厦门X平台账号截图
此外，国际性展会平台也为中国城市提供了形象展示的场域。通过高规格的全球化展示窗口，中国城市得以系统性地整合经济实力、文化底蕴与创新活力等核心要素，构建立体化的城市品牌叙事。
本监测周期，海口应用上述策略，紧抓第五届中国国际消费品博览会重要时间节点，联动中国驻外外交官、国内外机构及全国30余个省市官方账号发布消博会相关帖文，不断扩大消博会的国际影响力。期间，海口账号还发布了WATERBOMB水弹音乐节等精彩视频，全面展现海口城市魅力，进一步提升海口在国际城市网络中的能见度与话语权。
▲海口X平台账号截图
（三）中国城市照片墙传播力指数
2025年4月，中国城市照片墙传播力指数排序相对靠前的城市是：南京、北京、成都、厦门、常州、上海、佛山、杭州、扬州、张家界。
▲中国城市照片墙传播力指数TOP10（制图：世研指数）
自然生态资源与历史文化遗产构成城市国际传播的核心资产。这些要素禀赋通过在地特征与普世价值的有机结合，能够突破文化边界，形成独特的城市叙事资本。
本监测周期，张家界首次跻身中国城市照片墙传播力指数排序前十，其有效应用了上述策略。在操作层面，如4月18日，其账号发布的一段展示三管佩刀跽坐铜俑的视频，呈现出张家界深厚的本土文化立面。截至统计日，该视频获赞1384次，凸显张家界历史文化议题为构建差异化城市品牌形象提供了独特的竞争优势，最终转化为其可持续的国际传播影响力。
▲张家界照片墙账号截图
（四）中国城市优兔传播力指数
2025年4月，中国城市优兔传播力指数排序相对靠前的是：重庆、北京、南京、杭州、绍兴、沧州、苏州、成都、广州、西安。
▲中国城市优兔传播力指数TOP10（制图：世研指数）
企业作为城市国际传播网络中的关键节点之一，其市场化运作机制与全球化商业网络覆盖，能够有效助力城市品牌拓展国际传播半径。
本监测周期，杭州借助企业开展国际传播，其所发布视频观看量达47900次，较上一监测周期有大幅度提升。
在操作层面，如杭州账号发布的“浙商出海系列对接会摩洛哥站——走进海亮”视频，介绍了大会盛况，展示了中摩两国青年交流场景。截至统计日，该视频播放量达1.2万次。上述传播不仅有利于丰富城市叙事的呈现维度，还有利于实现城市形象的多层次触达，构建更具韧性的国际传播生态体系。
▲杭州优兔账号截图
（五）中国城市TikTok传播力指数
2025年4月，中国城市TikTok传播力指数排序相对靠前的是：北京、天津、南京、镇江、长沙、青岛、常州、桂林、深圳、盐城。
▲中国城市TikTok传播力指数TOP10（制图：世研指数）
创新性的传播形态构建，是城市在国际舆论场实现差异化突围的重要路径。通过媒介技术的创造性应用与叙事范式的突破性重构，能够有效破解同质化传播困境。
本监测周期，天津创新传播形式，其TikTok账号观看量达103.94万次，平均观看率达79954，在中国城市TikTok传播力指数中表现优异。
在操作层面，4月25日，天津账号发布一条创意视频，将汉字与天津的日常美景相融合，通过每一笔展现的独特魅力呈现天津的文化重量，有利于海外受众更深入地了解天津。截至统计日，该视频播放量超20万次。本轮传播中，天津的创新不仅体现在视觉表现形式的革新，更本质的是传播思维从“信息传递”到“价值共创”的范式跃迁，具有较强的借鉴价值。
▲天津TikTok账号截图
此外，多元化议题矩阵的构建，为城市国际传播提供了更为全面、立体的叙事空间。通过议题的有机整合，不仅能够立体呈现城市的复杂肌理，更能在跨文化语境中建立更具包容性的对话框架。
深圳在本监测周期应用上述策略，表现出色。其中，深圳市南山区TikTok账号自4月上线后，在议题设置方面紧扣“洞察深圳”这一核心，围绕科技创新、文化艺术、都市生活三大板块展开内容创作，精心策划了一系列短视频。在科技创新方面，展示南山高新技术企业的研发成果与创新场景；文化艺术板块聚焦了各类艺术展览、民俗活动；都市生活版块则展现了南山丰富多元的餐饮娱乐与休闲时光，全面且生动地呈现出南山的独特魅力与发展活力。目前，该账号粉丝数已超过2万，短视频总播量突破11万，收获大量海外用户的点赞与关注，引发积极的舆论反馈，为深圳实现从城市形象碎片化呈现到系统性建构的质变提供了有效助力。
三、研究说明
“中国城市海外社交媒体传播力指数”以中国城市主要官方账号为指数评估主体，依据其在多个海外社交媒体平台上的多维度传播数据，通过指数模型运算，实现对城市国际传播效力的指数得分。根据各平台的全球用户规模、活跃度、影响力相关度等因素动态设定平台权重，各平台指数加权计算形成综合传播力指数。国际传播力指数体系算法包括定性与定量两部分。其中，定量指标权重占比80%，定性指标权重占比20%。
▲研究说明 制图：世研指数
本指数的数据获取方式为：筛选海外社交媒体平台上有传播行为的中国城市的官方账号，纳入大数据监测系统，获取该官方账号的传播行为数据，包括但不限于内容创作数据（Generate）；互动交流数据（Interactive），包括分享、评论和认可等行为动作所产生的数据；用户享用信息数据（Utilize），包括订阅/关注、浏览等行为动作所产生的数据。指数模型设计及制图由世研指数提供。",社会 # 国际 # 科技 # 文化,9,5672,13,5685,https://www.cankaoxiaoxi.com/#/detailsPage/cankaozk/158f0649979e4099b06b6ca6042ff4b6/1/2025-05-23%2010:52?childrenAlias=undefined
55,"参考消息网5月22日报道 参考智库与世研指数日前联合发布“中国省级文旅海外社交媒体传播力指数（2025年4月号）”。本指数以2025年4月1日至4月30日为监测周期。数据覆盖范围为5个海外社交媒体平台：脸书（Facebook）、X平台、照片墙（Instagram），视频平台YouTube和TikTok。
截至统计日，中国省级文旅机构在上述平台开设账号并处于运营状态的数量如下：脸书24个、X平台24个、照片墙25个、视频平台23个。
总体而言，本监测周期，中国省级文旅账号活跃度进一步提升，在议题设置上，侧重在“美景、文化、科技”等体验感较强的领域设置话题，吸引海外受众关注并参与互动。中国省级文旅账号通过“他说他感”的沉浸式展示方式多方位呈现本土文旅风貌，助力塑造生机盎然、真实可信的城市海外形象。
中国省级文旅海外社交媒体传播力指数TOP20总览（2025年4月）
一、总体情况
在综合传播力方面，排序前二十的中国省级文旅账号为：北京市、江苏省、江西省、山东省、辽宁省、安徽省、陕西省、新疆维吾尔自治区、吉林省、甘肃省、重庆市、云南省、广西壮族自治区、福建省、上海市、四川省、浙江省、内蒙古自治区、贵州省、河南省。
中国省级文旅海外社交媒体综合传播力指数TOP20（2025年4月）
与上一监测周期相比，排序相对靠前的中国省级文旅账号差异不大，“第一梯队”中仅个别省级文旅账号出现排序微调，如北京市再次超越江苏省居首位。在其他省级文旅账号中，河南省取代黑龙江省，进入排序前二十。
本监测周期，江西省在综合传播力指数中表现优异，其物质和非物质文化遗产共同铸造了一张又一张闪亮的城市名片，吸引海外受众关注。如4月22日，其脸书账号发布网帖称：“#江西旅游：这个五一假期逃离城市，沉浸在葛仙村的魅力中! 古老的道教文化、壮丽的风景和宁静的氛围等待着你。”截至统计日，该网帖获得超过2.1万次点赞。又如4月18日，其X平台账号发布网帖称：“国字山墓群是江西发现的最大的东周墓葬群，距今已有2000多年的历史。所有者的身份是根据两件出土的武器确定的，这两件武器曾经属于东周（公元前770-256年）一位著名国王的后代。该墓的挖掘始于2017年，已发现超2600件物品，从金属器皿、陶器和玉器到乐器、武器和日常用品。”截至统计日，该网帖获得超过22.7万次浏览量，对提升江西文旅海外形象辨识度形成支撑。
江西文旅脸书、X平台账号相关网帖截图
二、各海外社交媒体传播力情况
（一）中国省级文旅脸书传播力指数
2025年4月，中国省级文旅脸书传播力指数排序前二十的是：北京市、山东省、江苏省、甘肃省、江西省、陕西省、辽宁省、安徽省、新疆维吾尔自治区、吉林省、浙江省、贵州省、重庆市、内蒙古自治区、云南省、四川省、广西壮族自治区、河南省、福建省、黑龙江省。
中国省级文旅脸书传播力指数TOP20（2025年4月）
本监测周期，陕西文旅表现可圈可点。在策略应用方面，陕西文旅以标志性文化符号为抓手，创新文案设计，打破时间和空间的距离，以古今对碰、中西融合的表达方式强化其海外形象辨识度。
如4月20日，陕西文旅脸书账号结合海外受众熟悉的节日，发布了一则有趣的图文网帖，图片中兵马俑拿着吉他，以摇滚歌手的形象，向游客吟唱着来自东方的神秘故事。其融贯中西与古今的内容表达，可引发海外受众对兵马俑的好奇与探知欲。截至统计日，该网帖获得海外受众超1.1万次的点赞互动。
陕西文旅脸书账号相关网帖截图
（二）中国省级文旅X平台传播力指数
2025年4月，中国省级文旅X平台传播力指数排序前二十的是：北京市、江西省、江苏省、辽宁省、山东省、陕西省、甘肃省、吉林省、安徽省、新疆维吾尔自治区、四川省、云南省、广西壮族自治区、福建省、内蒙古自治区、浙江省、重庆市、贵州省、河南省、黑龙江省。
中国省级文旅X平台传播力指数TOP20（2025年4月）
本监测周期，甘肃文旅在本维度排序第七，较上一监测周期前进两位，表现稳定。在策略应用方面，甘肃文旅以独特的地质地貌为切入点，通过极具视觉冲击力的图片，给海外受众留下深刻印象，从而展现其独特魅力和人文气质，进一步提高海外美誉度。
如4月4日，甘肃文旅在其X平台账号发布了一则甘肃优质旅游路线的图文网帖，展示了张掖丹霞特有的风采，不同颜色的地貌交织在一起给人带来如彩虹般的视觉震撼。截至统计日，该网帖收获超过3100次点赞，有利于进一步提升甘肃文旅对海外游客的吸引力。
甘肃文旅X平台账号相关网帖截图
（三）中国省级文旅照片墙传播力指数
2025年4月，中国省级文旅照片墙传播力指数排序前二十的是：山东省、北京市、安徽省、江苏省、江西省、甘肃省、陕西省、辽宁省、吉林省、新疆维吾尔自治区、福建省、广西壮族自治区、内蒙古自治区、贵州省、重庆市、上海市、浙江省、四川省、黑龙江省、河南省。
中国省级文旅照片墙传播力指数TOP20（2025年4月）
本监测周期，山东文旅在上述维度中表现突出，其排序相较上一监测周期上升一位，居首位，显示出其照片墙传播力具有相对稳定的优势。在策略应用方面，山东文旅以传统文化为推手，深入挖掘其在跨文化传播中的价值，使其成为文旅走向国际化的“加速器”和“通用符号”。
如4月20日是中国传统24节气中的谷雨，第42届潍坊国际风筝节如期举行，山东文旅在其照片墙账号中发布了潍坊国际风筝节的宣传海报，向世界展示“世界风筝之都”潍坊的城市风采。截至统计日，该网帖共获得超过2.7万次点赞，有利于强化山东海外形象中的独特文化标签。
山东文旅照片墙账号相关网帖截图
（四）中国省级文旅视频平台传播力指数
2025年4月，中国省级文旅视频平台传播力指数排序前二十的是：江苏省、北京市、江西省、辽宁省、山东省、新疆维吾尔自治区、安徽省、吉林省、陕西省、云南省、重庆市、广西壮族自治区、上海市、福建省、西藏自治区、甘肃省、四川省、河南省、河北省、黑龙江省。
中国省级文旅视频平台传播力指数TOP20（2025年4月）
本监测周期，北京文旅账号在上述维度中表现优异。在策略应用方面，“历史遗产+传统文化+自然景观”相融合的展示方式，不仅向海外受众呈现出一帧帧唯美画面，而且营造了扑面而来的历史厚重感，跨越时空的直观再现式宏大表达强化其“历史悠久”的海外形象。
如4月13日，北京文旅在其视频平台账号中发布了一则介绍智化寺的视频，用57秒时长的视频向海外受众展示了北京保存最完好的明代木结构建筑。特别本监测周期恰逢春花盛放，海外受众以鲜活生动的视角，辅以京城礼乐的听觉享受来“游览”这一有着500多年历史的文化遗产。截至统计日，该视频观看量超过180万次，互动量超过2800次。
北京文旅视频账号相关网帖截图
三、研究说明
“中国省级文旅海外社交媒体传播力指数”以中国各省、直辖市、自治区文旅厅（局）在海外社交媒体平台上开设的官方账号为指数评估主体，依据其在不同海外社交媒体平台上的多维度传播数据，通过指数模型运算，实现对中国省级文旅海外社交媒体传播力的指数得分。根据各平台的全球用户规模、活跃度、影响力相关度等因素动态设定平台权重，各平台指数加权计算形成综合传播力指数。中国省级文旅海外社交媒体传播力指数体系算法包括定性与定量两部分。其中，定量指标权重占比80%，定性指标权重占比20%。
研究说明 制图：世研指数
本指数的数据获取方式为：将各省、直辖市、自治区文旅厅（局）在海外社交媒体平台上开设的官方账号纳入大数据监测系统，获取该官方账号的传播月度数据，包括但不限于内容创作数据（Generate）；互动交流数据（Interactive），包括分享、评论和认可等行为动作所产生的数据；用户享用信息数据（Utilize），包括订阅/关注、浏览等行为动作所产生的数据。指数模型设计及制图由世研指数提供。
课题组成员：
参考智库：张诚、张陆煜、崇珅、张威威、李倩
世研指数：刘志明、徐善水、刘洋、马文凤、支春云",#旅游 #文化 #社交媒体 #国际传播 #城市形象,9,4252,13,4265,https://www.cankaoxiaoxi.com/#/detailsPage/cankaozk/3434acc334d5499f942b40dab8c697cf/1/2025-05-22%2014:29?childrenAlias=undefined
56,"参考消息网5月21日报道 参考消息报社参考智库日前发布《中国百城海外传播力月度分析报告（2025年4月号）》。
本报告以2025年4月1日至4月30日为监测周期，监测对象涵盖包括直辖市、省会城市、副省级城市、特色城市、边境城市等（不含港澳台）在内的100个中国城市。
总体来看，本监测周期，城市运用多元化传播策略，围绕“开放、交流、合作”等关键词进行议题设置，通过多媒介渠道形成广泛传播链条，在经贸文体多领域引发海外受众共鸣，助力城市海外形象塑造。
具体而言，一是国际性展会、论坛和研讨会的举办，加速城市国际化进程，扩容城市海外朋友圈；二是航空航天发展既是国家实力的体现，亦助力相关城市提升国际关注度和知名度；三是对外贸易打通城市连接全球的通道，展示城市经济发展动能的同时，也助力城市文化的海外传播；四是承办国际性体育赛事，既助力城市积累参与国际事务的经验，又为城市建构良好海外口碑提供契机。此外，本监测周期，正值清明、谷雨时节，春末夏初，城市文旅议题设置精彩纷呈，展现各地特色文化、积极与海外受众交流互动……为城市海外美誉度和辨识度打造提供正向支撑。
一、总体情况
中国百城海外传播力月度指数由海外传播度和海外美誉度两个一级指标构成，旨在对中国城市国际传播的综合影响力进行评估。本监测周期内，海外影响力月度指数排序前20的城市涵盖东中西部地区。在传播策略方面，排序相对靠前的城市总体呈现出主动设置议题意识较强、经济相对发达、对外贸易历史悠久等特点，城市的对外开放水平和国际化程度相对更高。
▲海外影响力月度指数前20
具体情况如下：
一是举办国际性展会、论坛和研讨会，可助推城市驶入国际化发展快车道。如4月13日，第五届中国国际消费品博览会在海口举办，吸引全球70多个国家和地区的1700余家企业参展。又如4月23日至25日，第三届联合国教科文组织国际博物馆高级别论坛在杭州举行，来自60余个国家和地区的专家齐聚，探讨博物馆在文化遗产保护、新技术应用等方面的经验做法。再如，4月26日，2025国际中医经方经药康养合作交流研讨会在成都举行，来自全球20余个国家的中医药领域专家、学者、产业及地方代表等300余人参会，共同探讨中医经方经药在疗愈旅居、健康文旅等新业态中的融合发展。
国际性的展示交流活动，可推动城市在相关领域的影响力，对提升城市国际声誉和海外美誉度形成有效助力。
二是以空间技术为代表的高科技发展成果快速拉升城市国际关注度。如4月30日，神舟十九号载人飞船返回舱在酒泉成功着陆。又如4月19日，我国在太原卫星发射中心成功将试验二十七号卫星01星-06星发射升空，顺利进入预定轨道。科技强国、科技强市，科技硬实力是城市占据国际舆论核心的底气和强化剂。
三是对外贸易的高质量发展为城市国际传播搭建通路。本监测周期，对外贸易对城市国际传播的影响主要体现在两个方面。一是物流的升级助力外贸交易提速的同时，也促成了境内外相关城市的高频共振。如4月29日，广州港新开通至南美西海岸钱凯港的直航航线，货物从南沙出发，只需30天左右就能直达秘鲁钱凯港。二是积极开展外资引进宣传，有利于相关城市更为主动地向国际社会展示自身优势，强化城市形象标签和辨识度。如4月24日，天津投资环境推介会在英国伦敦举行，打造开放、包容、互利、共赢的天津国际形象。高质量的对外贸易可以通过具体的产品和服务，以“润物细无声”的方式讲述城市故事、展示城市形象，起到赋能国际传播的作用。
四是国际体育赛事为承办城市带来形象宣传和国际影响力提升的机遇。广泛的海外受众群体和全球媒体的集中关注强化相关城市的国际口碑塑造。如4月18日，第三届杭州（桐庐）国际马术场地障碍赛开幕，来自17个国家和地区的超400对人马组合参赛；又如2025年苏迪曼杯世界羽毛球混合团体锦标赛于4月27日在厦门开幕。国际性体育赛事助力城市与国际接轨，提升国际化水平。
此外，本监测周期，春末夏初，时节交替间，中国城市呈现各不相同的时光色彩。各城市根据当地本土特色继续发力文旅议题设置，在海外社交媒体发布充满诗意的美图美景，巩固城市文化烙印和海外美誉度。
二、海外传播度
在海外传播度指标方面，排序前20的城市与海外影响力前20的城市基本一致。其中，北京领先优势明显，上海、深圳、广州、武汉、成都、厦门、杭州、重庆、天津等多个城市亦有突出表现。
▲海外传播度月度指数前20
本监测周期，经贸文化交流合作议题的表现较为突出，有效赋能城市国际传播，在境外传统媒体和海外社交媒体中均有正向效果呈现。在海外传播度排序前20的城市中，北京、上海、深圳、广州、成都、武汉6座城市表现抢眼，同时进入媒体关注指数和海媒关注指数两个二级指标排序前列。
上述城市将经贸交流合作与文化相融合，传播效果较为明显。其反映在媒体关注指数下辖的海外媒体发稿量、海外媒体覆盖国家量、海外媒体覆盖语种数量、海外媒体家数、海外主流媒体发稿量5个三级指标中，北京、上海、深圳、广州等城市以较明显的优势居于领先地位。
▲媒体关注指数前20
▲海媒关注指数前20
（一）媒体关注指数
本监测周期，航天动态助推太原国际影响力的提升，其在媒体关注指数中表现较好。
4月19日，我国在太原卫星发射中心使用长征六号改运载火箭，成功将试验二十七号卫星01星-06星发射升空，引发境外媒体集中关注。欧洲新闻社、俄罗斯国际文传电讯社、非洲通讯社、阿根廷布宜诺斯艾利斯经济新闻网、美国太空新闻网、突尼斯《新闻报》、《新兴尼泊尔报》等媒体成为主要信源和传播主体，报道基调积极正向。
如欧洲新闻社网站报道称：“4月19日，中国在山西省太原发射中心成功发射了六颗新的试验卫星。中国航天局表示，这些卫星主要用于‘空间环境探测’和‘技术试验’。”
▲欧洲新闻社网站相关报道截图
美国太空新闻网报道称：“长征六号改运载火箭能够将4500公斤的有效载荷发射到700公里的太阳同步轨道。它在太原航天发射中心拥有一个专用发射台。”
▲美国太空新闻网相关报道截图
本轮传播中，在卫星发射相关报道中，太原被频繁提及，有利于强化太原海外形象中的“高科技”标签。
（二）海媒关注指数
本监测周期内，海媒关注指数表现较为亮眼的城市为成都，其在排序前20的城市中位列第四。值得注意的是，在海媒关注指数下辖的两个三级指标——点赞量和评论量上，成都分别位列第六和第五。这些数据表明，成都在海外社交媒体平台上获得了较高的关注。
▲点赞量
▲评论量
本监测周期，积极推进国际交流与合作，让外国友人感受、体验本土文化，成都在扩建国际朋友圈的过程中进一步提升了国际传播效能。如在照片墙平台，成都账号“hellochengdu”发布的题为《成都国际体验官——来成都逛春糖，爱尔兰友人的推荐》的视频，视频镜头跟随爱尔兰人Stephen Randles的脚步，一起探索、感受成都的城市氛围，向海外受众展现出成都城市的开放姿态与商品市场的蓬勃活力及城市海内外经贸交流盛况。截至统计日，该网帖观看量超过33万次。
▲相关网帖截图
都江堰放水节作为历史悠久的传承活动，具有重要的历史价值、文化价值、科技价值和民俗价值。今年的庆典活动邀请众多外国友人参与其中，沉浸式了解、感受都江堰的治水文化及智慧。在X平台，成都账号“Chengdu China”发布视频网帖：“惊艳的中国传统！古老的都江堰放水节拉开帷幕，成都和重庆的领事们齐聚一堂，共同颂扬李冰父子的智慧。”相关内容传播效果良好。
▲相关网帖截图
三、海外美誉度
在海外美誉度指标方面，排序前20的城市大多也都在海外传播度指标的前20当中，北京、上海相对领先，其后是深圳、武汉。
▲海外美誉度月度指数前20
从海外形象指数和海媒评价指数两项二级指标看，厦门在海外传统媒体和社交媒体均收获较为积极的城市形象，分别位列海外形象指数的第11和海媒评价指数的第12。
本监测周期内，2025年世界田联钻石联赛在厦门拉开新赛季帷幕。据介绍，钻石联赛是世界田联赛事体系中竞技水平最高的单日系列赛。该项赛事国际影响力和关注度都较高，对厦门国际传播和形象塑造的正向带动效应显著。
世界田联钻石联赛举行期间，路透社、马来西亚《星报》、《新海峡时报》、《法兰西西部报》、尼日利亚《抨击报》、菲律宾《马尼拉时报》等多家境外主流媒体及众多体育媒体都对该项赛事进行了报道。作为赛事举办地，厦门在相关报道中被大量提及。
如马来西亚《星报》网站报道称：“挪威选手卡尔斯滕·沃霍尔姆26日在厦门举行的2025年钻石联赛开幕赛上，在新设立的300米栏比赛中，以33.05秒的成绩创造了世界最好成绩，为这一周的精彩表现画上了圆满的句号。”
▲马来西亚《星报》网站相关报道截图
与此同时，世界田联钻石联赛的相关内容在海外社交媒体平台也受到较高关注。如非洲资讯平台“Africa Facts Zone”X平台账号发布内容为“在厦门钻石联赛男子100米比赛中，南非选手Akani Simbine以9.99秒的成绩夺冠。他在博茨瓦纳黄金大奖赛男子100米比赛中以9秒90的成绩夺冠。”的网帖。截至统计日，该网帖浏览量达14万，收获点赞量5221次。
▲“Africa Facts Zone”X平台账号截图
厦门亦积极开展主动传播，其X平台账号发布内容为“中国东南部福建省厦门市正以体育为画笔，在城市经济增长的画布上描绘出辉煌的篇章。……上周，厦门再次迎来了体育领域的闪亮时刻。世界田径钻石联赛和第19届苏迪曼杯世界羽毛球混合团体锦标赛在本市举行，成为人们关注的焦点。”的网帖。截至统计日，该网帖浏览量达2.2万，收获点赞量158次。
▲厦门X平台账号截图
四、研究说明
“中国百城海外传播力月度分析报告”以中国城市在海外主流媒体及社交媒体中的传播效果为主要评估方向，下设两个一级维度：海外传播度和海外美誉度。
海外传播度设有两个二级指标：媒体关注指数及海媒关注指数，并包括海外媒体发稿量、海外媒体覆盖国家量、海外媒体覆盖语种数量、海外媒体家数、海外主流媒体发稿量、点赞量、评论量、分享量及社交媒体覆盖语种数量等三级指标。
海外美誉度同样设有两个二级指标：海外形象指数及海媒评价指数，并包括正面舆情发稿被转载（转引）量、正面舆情发稿被海外主流媒体转载（转引）量、海外媒体正面舆情发稿量、海外媒体正面舆情发稿量占全部稿件量比例、正面发帖数量以及正面发帖占所有发帖数量比例等三级指标。
本报告通过对各维度、指标数据进行加权、归一，得出研究结论。需要说明的是，定量分析的指标选择、模型搭建和参数设置，必然带有一定主观性，不同的指标选择和参数设置，很可能带来不同的定量结果。报告中使用定量分析的目的，是为了更加准确地展示中国城市海外传播关注度的具体情况，其分析结论并不具有“排名”结果，而是为外界提供更详实的参考作用。
五、关于我们
参考智库《中国百城海外传播力月度分析报告》依托参考消息海外舆情大数据库及信息监测系统，研究范围涵盖英文、俄文、法文、德文、西班牙文、葡萄牙文、日文、阿拉伯文等多个主要文种信源，覆盖上千家境外媒体及多个主要海外社交媒体平台，以海外关注度较高的100个中国城市（未含港澳台地区）的舆情数据为基础进行测算。旨在综合评估中国城市国际传播和国际品牌建设效果，为城市决策者、研究者提供国际传播领域的业务参考。
参考智库成立于2020年5月，是新华社国家高端智库成员单位，也是参考消息报社智库平台，拥有丰富的海外舆情资源和业内一流的海外舆情分析师队伍，通过人工智能、大数据等先进技术赋能，定期推出城市国际传播、海外舆情分析报告。参考智库连续发布《中国城市海外影响力分析报告》，为中国城市国际传播、打造城市软实力“问诊把脉”。",#国际 #科技 #社会 #财经 #文化,10,6086,12,6098,https://www.cankaoxiaoxi.com/#/detailsPage/cankaozk/cc58fa8084474bff82014113ece41410/1/2025-05-21%2009:22?childrenAlias=undefined
57,"参考消息网5月14日报道 参考消息报社参考智库日前发布《中国百企海外传播力月度分析报告（2025年4月号）》。本报告以2025年4月为监测周期，监测对象涵盖科技、金融、能源、汽车、医药、航空、电子消费品等领域的中国企业。监测主要维度为海外传播度、海外影响度及海外美誉度，并从发稿量、主流媒体报道量、报道媒体家数、覆盖国家范围、语种、网帖点赞量、分享量、评论量，以及舆论情感基调等诸多角度，对主要维度予以评估、解读。
本监测周期内，境外媒体对中国企业的有效报道总篇数约为67987篇次，涉及45个语种，至少1286家境外媒体在报道中提及中国企业。与上一监测周期相比，除境外媒体报道家数略有下降外，其他两个指标均有所上升，凸显中国企业海外舆情热度依然处于升温通道。
报告显示，2025年4月海外传播力较高的中国企业为华为、小米、中国电信、腾讯及小鹏汽车，比亚迪、中核集团、京东、中石油及广汽等企业关注度也相对较高。总体而言，报道基调相对中性。
▲中国百企海外传播力总体情况
与上一监测周期相比，排序前20的企业所涉行业进一步扩大，主要包括科技、能源、消费、电子等行业，凸显中国企业国际传播的行业多元化态势日趋显著。
▲中国百企海外传播力之海外传播度指数
▲中国百企海外传播力之海外影响度指数
▲中国百企海外传播力之海外美誉度指数
一、传统媒体传播现状
（一）中国电商行业新动作引发境外媒体集中关注
海外媒体关注指数是体现中国企业海外综合舆情热度的重要指标，也是体现企业影响力的主要维度之一。
▲海外媒体关注指数
本监测周期内，中国电商企业海外市场动作受到境外媒体普遍关注。京东、拼多多等中国企业在上述维度中排序相对靠前。
在议题方面，境外媒体主要围绕跨境电商在中国出口贸易中的作用进行设置。如《日本经济新闻》网站称：“中国电商巨头京东集团宣布，为协助中国出口企业开拓国内市场渠道，今后一年将投入至少2000亿元采购出口转内销商品。”报道还关注到：“京东2024财年（截至12月）财报显示，净利润同比增长71%超413亿元，全年收入增长近7%达11588亿元（人民币）。”
英国《金融时报》网站亦报道称：“京东和拼多多等电商巨头发布数以百亿美元计的行动，帮助传统出口商转内销。”
除上述议题外，部分境外媒体还关注中国电商企业在海外市场中的实力。如美国彭博新闻社网站报道称：“Temu取代Allegro成为波兰最大的电子商务平台。据研究公司Gemius Mediapanel的数据，今年3月，拼多多旗下的Temu在波兰拥有的实际用户超越Allegro。这是这家波兰老牌公司首次被竞争对手超越。”
（二）人工智能议题热度持续走高拉升中国科技企业舆情热度
海外媒体覆盖语种数量及关注中国企业的海外媒体家数是评估涉中国企业报道的传播范围广度及传播链条长度的重要指标，与中国企业的国际传播能力关系密切。
▲海外媒体覆盖语种数量
▲关注中国企业的海外媒体家数
本监测周期内，中国科技企业，如腾讯、小米等在上述维度中的表现均相对突出。就议题层面而言，境外媒体对中国人工智能产业政策及中国科技企业在人工智能领域的发展依然保持着较高的关注度。
如香港《南华早报》网站报道称：“在新闻发布会上，广东推介了旨在吸引人工智能和机器人人才的政策，同时强调了华为技术有限公司和腾讯控股等本土科技巨头的能力。”报道关注到：“其中一项激励措施包括为符合条件的‘人工智能和机器人制造业创新中心’提供最高5000万元人民币的资金支持，为单个优质企业提供最高300万元人民币的奖励。”
部分境外媒体观察到中国科技企业在人工智能领域高速发展的大背景，如西班牙《阿贝赛报》网站认为，中国研发投入反映其“将科技创新置于长期发展核心的战略决心”。报道称：“初创企业还获得科技巨头扶持，华为、腾讯等科技巨头管理着自己的风险投资基金，领投融资轮次并提供加速计划。”
（三）中国汽车企业“跨界”发展，舆情热度继续保持高位
海外媒体覆盖指数及海外媒体触达指数是衡量企业国际传播能力与效力的重要指标，也是体现海外媒体对企业关注程度的关键指标。
▲海外媒体覆盖指数
▲海外媒体触达指数
本监测周期，中国汽车企业舆情热度继续保持高位。北汽、广汽、上汽等中国汽车企业，均在上述维度中排序相对靠前。
就议题层面而言，境外媒体普遍关注中国汽车企业“跨界”发展。如《日本经济新闻》网站报道称：“中国国有汽车巨头广州汽车集团宣布，将于2025年内建成验证自研人形机器人应用场景的实证区。设想用于安保用途及汽车售后服务相关场景，计划2026年前确定应用领域，2027年启动量产。”该媒体还援引行业专家的话称：“人形机器人约70%零部件与电动车通用。比亚迪、广汽等电动车巨头正通过投资与自主研发加码该领域。”
除上述议题外，中国汽车企业的海外市场动向，亦受到境外媒体关注。如泰国《民族报》网站报道称，三家已在泰国建立了大型制造工厂的中国汽车制造商正计划扩大生产能力，报道提到：“上汽集团春武里工厂目前生产MG5、MG ZS（1.5L发动机）、MG HS PHEV等车型，出口到越南和印度尼西亚，并计划今年扩展到马来西亚。”
二、社交媒体传播现状
（一）持续挖掘国际会议传播潜力，以全球化视角策划议题
海媒关注指数及评论量是评估中国企业在海外社交媒体中触达度的重要指标。本监测周期内，中国科技企业，如华为，在上述两个维度中表现相对突出，凸显其持续挖掘国际会议传播潜力，以全球化视角策划议题的传播方式取得一定效果。
▲海媒关注指数
▲评论量
在具体操作层面，华为聚焦智慧城轨峰会，关注亚洲各地嘉宾的精彩言论，并将其制作成短视频，在其X平台账号中及时发布。如其4月25日发布网帖称：“华为智慧城轨峰会探讨云网融合、数据与人工智能赋能，加速城轨智能化进程。来自亚洲各地轨道交通行业的嘉宾分享了创新实践。”截至统计日，该网帖浏览量达120万。
▲相关网帖截图
又如4月17日，其在X平台发布网帖称：“重温2025年马拉喀什华为智能非洲峰会的精彩瞬间和亮点，华为北部非洲（北非、西非和中非）总裁发表主旨演讲。他在演讲中强调了以整合协作的方式加速整个非洲大陆人工智能发展的重要性：‘我们将继续携手产业各方，围绕人工智能产业发展的政策、技术、生态、人才等领域进一步深化合作，加速智能化，共建新非洲。’”截至统计日，该网帖浏览量达120万，点赞量达445次。
（二）以直观方式展示企业实力，提升海外形象认同度
海外社交媒体点赞量及分享量是与企业海外形象美誉度关系密切的重要指标。本监测周期内，小鹏汽车在点赞量方面表现突出，凸显其以直观方式展示企业实力，提升海外形象认同度的传播策略效果良好。
▲点赞量
▲分享量
在操作层面，小鹏汽车注重以数据展现企业实力。如4月17日，小鹏汽车在X平台发布网帖称：“你的下一次充电就在不远处。#小鹏拥有分布31个国家的207万多个充电站，让电动汽车在全球范围内触手可及。”截至统计日，该网帖浏览量达250万，点赞量达213次。
▲相关网帖截图
（三）覆盖语种数量与上一监测周期持平，科技企业优势明显
2025年4月，中国企业在海外社交媒体平台网帖语种数量为71种，与上一监测周期持平。在排序相对靠前的企业中，科技企业依然优势明显，通讯、汽车及航空航天企业表现亦较为抢眼。
具体而言，本监测周期内，在该维度排序前十的企业中，小米与腾讯组成“第一梯队”，持续形成明显优势。海思半导体及华为紧随其后，组成“第二梯队”。总体而言，“第二梯队”成员数量较上一监测周期进一步收窄。
▲覆盖语种数量
三、研究说明
“中国百企海外传播力月度分析报告”以中国企业在海外主流媒体及社交媒体中的传播效果为主要评估方向，下设三个一级维度：海外传播度、海外影响度以及海外美誉度。其中，海外传播度设有两个二级指标：媒体关注指数及海媒关注指数，并包括海外媒体发稿量、海外媒体覆盖国家量、海外媒体覆盖语种数量、海外媒体家数、海外主流媒体发稿量、点赞量、评论量、分享量及社交媒体覆盖语种数量等三级指标。
海外影响度设有两个二级指标：媒体覆盖指数及媒体触达指数，并包括海外媒体转载（转引）量、转载媒体家数、转载覆盖国家数量占境外国家比例、主流媒体触达度、媒体触达度等三级指标。
海外美誉度同样设有两个二级指标：海外形象指数及海媒评价指数，并包括正面舆情发稿被转载（转引）量、正面舆情发稿被海外主流媒体转载（转引）量、海外媒体正面舆情发稿量、海外媒体正面舆情发稿量占全部稿件量比例、正面发帖数量以及正面发帖占所有发帖数量比例等三级指标。
本报告通过对各维度、指标数据进行加权、归一，得出研究结论。需要说明的是，定量分析的指标选择、模型搭建和参数设置，必然带有一定主观性，不同的指标选择和参数设置，很可能带来不同的定量结果。报告中使用定量分析的目的，是为了更加准确地展示中国企业海外传播关注度的具体情况，其分析结论并不具有“排名”结果，而是为外界提供更详实的参考作用。
四、关于我们
参考智库《中国百企海外传播力月度分析报告》依托参考消息海外舆情大数据库及信息监测系统，研究范围涵盖英文、俄文、法文、德文、西班牙文、葡萄牙文、日文、阿拉伯文等多个主要文种信源，覆盖上千家境外媒体及多个主要海外社交媒体平台，以海外关注度较高的100家中国企业（未含港澳台地区）的舆情数据为基础进行测算。报告将逐月评估各企业外媒关注热度变化。
参考智库成立于2020年5月，是新华社国家高端智库成员单位，也是参考消息报社智库平台，拥有丰富的海外舆情资源和业内一流的海外舆情分析师队伍。通过人工智能、大数据等先进技术赋能，定期推出企业国际传播、海外舆情分析报告。2021年开始，参考智库连续发布《中国企业海外传播力分析报告》，为中国企业国际传播、打造企业软实力“问诊把脉”。",科技 # 财经 # 国际 # 社会,9,5042,15,5057,https://www.cankaoxiaoxi.com/#/detailsPage/cankaozk/116a72ce22654889a7f63b882916a05a/1/2025-05-14%2009:27?childrenAlias=undefined
58,"参考消息网6月19日报道 据法新社6月18日报道，美国媒体娱乐和体育电视台（ESPN）18日报道，洛杉矶湖人队即将以创纪录的100亿美元价格被出售，这将使这支美国男子职业篮球联赛（NBA）球队成为美国体育史上最昂贵的球队。
据ESPN报道，自1979年起就一直拥有湖人队的巴斯家族，将把球队的多数股权出售给亿万富翁马克·沃尔特，后者已持有该球队部分股份。尽管珍妮·巴斯将继续担任球队总裁，但这笔交易仍终结了其家族对这支NBA最受欢迎球队之一的长达四十多年的统治。湖人队曾17次夺得NBA总冠军奖杯，并在20世纪80年代凭借由“魔术师”约翰逊和卡里姆·阿布杜尔-贾巴尔领衔的“Showtime”王朝铸就传奇。
作为湖人队的新掌门，马克·沃尔特是TWG Global控股公司首席执行官。该公司已构建了令人瞩目的职业体育战队组合，包括洛杉矶道奇队（棒球）和洛杉矶火花队（美国女子职业篮球联赛），还拥有比利·简·金杯网球赛以及将于明年进军F1赛事的凯迪拉克车队。
此次易主标志着NBA一个时代的终结。1979年，魅力四射且特立独行的杰里·巴斯收购湖人队后，通过将竞技成绩与全方位娱乐体验（包括啦啦队和中场表演）完美结合，迅速将其打造为全球知名品牌。在巴斯家族执掌期间，这支从未被同城快船队掩盖光芒的洛杉矶旗舰球队，共斩获11座总冠军奖杯。
湖人队几个月前签下了卢卡·东契奇，确保了紫金军团（即洛杉矶湖人队）的传统在洛杉矶得以延续。但它尚未捧起第18个总冠军奖杯，如果成功，它将与劲敌波士顿凯尔特人队并列成为NBA夺冠次数最多的球队。
不过在等待追平这一纪录的同时，湖人队可以安慰自己，它的售价是迄今为止美国体育史上最高的，远超今年初凯尔特人队61亿美元的售价。（编译/林晓轩）",体育 # 篮球 # NBA # 洛杉矶湖人队,9,1172,17,1189,https://www.cankaoxiaoxi.com/#/detailsPage/tiyujk/54c1c007066e48769f69bed8ac83f71f/1/2025-06-19%2017:19?childrenAlias=undefined
59,"参考消息网6月19日报道 据法新社6月18日报道，美国媒体娱乐和体育电视台（ESPN）18日报道，洛杉矶湖人队即将以创纪录的100亿美元价格被出售，这将使这支美国男子职业篮球联赛（NBA）球队成为美国体育史上最昂贵的球队。
据ESPN报道，自1979年起就一直拥有湖人队的巴斯家族，将把球队的多数股权出售给亿万富翁马克·沃尔特，后者已持有该球队部分股份。尽管珍妮·巴斯将继续担任球队总裁，但这笔交易仍终结了其家族对这支NBA最受欢迎球队之一的长达四十多年的统治。湖人队曾17次夺得NBA总冠军奖杯，并在20世纪80年代凭借由“魔术师”约翰逊和卡里姆·阿布杜尔-贾巴尔领衔的“Showtime”王朝铸就传奇。
作为湖人队的新掌门，马克·沃尔特是TWG Global控股公司首席执行官。该公司已构建了令人瞩目的职业体育战队组合，包括洛杉矶道奇队（棒球）和洛杉矶火花队（美国女子职业篮球联赛），还拥有比利·简·金杯网球赛以及将于明年进军F1赛事的凯迪拉克车队。
此次易主标志着NBA一个时代的终结。1979年，魅力四射且特立独行的杰里·巴斯收购湖人队后，通过将竞技成绩与全方位娱乐体验（包括啦啦队和中场表演）完美结合，迅速将其打造为全球知名品牌。在巴斯家族执掌期间，这支从未被同城快船队掩盖光芒的洛杉矶旗舰球队，共斩获11座总冠军奖杯。
湖人队几个月前签下了卢卡·东契奇，确保了紫金军团（即洛杉矶湖人队）的传统在洛杉矶得以延续。但它尚未捧起第18个总冠军奖杯，如果成功，它将与劲敌波士顿凯尔特人队并列成为NBA夺冠次数最多的球队。
不过在等待追平这一纪录的同时，湖人队可以安慰自己，它的售价是迄今为止美国体育史上最高的，远超今年初凯尔特人队61亿美元的售价。（编译/林晓轩）",体育 # 财经 # 篮球 # NBA,9,1169,14,1183,https://www.cankaoxiaoxi.com/#/detailsPage/tiyujk/54c1c007066e48769f69bed8ac83f71f/1/2025-06-19%2017:19?childrenAlias=undefined
60,"参考消息网6月17日报道 法国《蓝色法国电台》网站6月15日发表一篇报道，题为《叶一飞成为史上首位夺得勒芒24小时耐力赛冠军的中国选手，圆了他14岁远赴勒芒的梦》。报道称，这是一次载入勒芒24小时耐力赛史册的胜利：在这项世界顶级汽车耐力赛中，25岁的法拉利车手叶一飞成为首位夺冠的中国车手。这个传奇故事始于他14岁独自赴勒芒学艺的岁月。
据报道介绍，叶一飞是2025年勒芒24小时耐力赛中，驾驶法拉利83号车组获胜的三位车手之一。他的队友罗伯特·库比查也将成为首位赢得该项赛事总冠军的波兰车手。
追梦的故事更加动人心魄，因为叶一飞在2024年就曾险些夺冠，最终却被迫退赛。25岁的叶一飞对勒芒这座城市再熟悉不过，因为这里正是他职业生涯的起点。14岁那年，他独自来到勒芒，怀揣着成为职业赛车手的梦想。十余年后，他载入了赛车运动史册。
为了实现这一目标，这位中国年轻车手不得不做出牺牲。正如他2023年接受法国一家电台采访时所说：“我和家人不得不做出牺牲正常生活的决定，我在14岁时离开家人、学校和朋友，独自一人来到勒芒生活。”
2014年，在中法两国汽车运动联合会达成协议后，他加入了法国汽联学院，这是一所专为年轻车手设立的培训机构。背井离乡，面对语言障碍，这名少年车手却始终坚持不懈，逐渐适应环境并学会了法语。在勒芒百年纪念赛前，他笑着说道：“这里的每一条赛道我都了如指掌。现在开着赛车飞驰，这种感觉太不可思议了。”
叶一飞曾夺得法国四级方程式锦标赛冠军，之后转战耐力赛场。2021年，他首次出征勒芒24小时耐力赛。当时他代表WRT车队出战LMP2组别，队友也是罗伯特·库比查。胜利在最后一圈因赛车故障与他们失之交臂。
2024年，他签约法拉利车队，在那里与罗伯特·库比查重聚。历史也在此重演，这次是在Hypercar组别：83号车组虽然在比赛中长时间领先，但却在比赛结束前3小时因故障退赛。此前的魔咒无疑让这次勒芒24小时耐力赛的胜利更加珍贵。
6月15日，法新社还报道了对叶一飞的采访。
法新社问：作为第一位在勒芒夺冠的中国人，你对此有何感受？
叶一飞答：我现在的心情难以言表。我想我需要一些时间才能完全消化今天发生的一切。此刻，我感觉自己像是在做梦，也许下一秒我就会醒来，而这一切都将不复存在。在上世纪90年代，马路上几乎看不到汽车，想成为职业车手在当时根本不可能。
问：你很早就来到勒芒进行训练了？
答：是的，11年前我14岁时就离开了家。那时我就想成为一名职业赛车手。我是通过一个交流项目来到勒芒的，刚到这里时，我真的还是个孩子。11年前，我根本不敢想象自己能走到今天。这一路上我不得不做出许多妥协，也经历过无数艰难时刻。但当我看到自己取得的成就，尤其是今天的这一切，我觉得所有的付出都是值得的。希望我在欧洲的这段历程，能够激励更多中国年轻车手。
问：整场比赛只出动过一次安全车，这意味着车手几乎没有喘息的机会。你是如何应对这种情况的？
答：是的，这是一场需要持续极限推进的比赛。就像排位赛那样，每一棒交接我们都必须全力冲刺、毫无保留，因为根本没有安全车。赛道上争取的每一秒都至关重要。无论是对体能还是意志，都是极其严苛的考验。（编译/刘卓）",体育 # 赛车 # 国际,10,1994,12,2006,https://www.cankaoxiaoxi.com/#/detailsPage/tiyujk/680fd5ef431e4c87967a69a031b4d3df/1/2025-06-17%2010:20?childrenAlias=undefined
61,"参考消息网6月15日报道 据西班牙《趣味》月刊网站6月12日报道，英国《可持续食品技术》杂志的最新研究揭示，软物质物理学正以前所未有的精度理解和设计食品结构，并控制其质地、稳定性和感官表现。人工智能和新兴技术则彻底变革了食品设计与生产方式。
“软物质”指凝胶、乳液、泡沫或胶体等材料，其特性介于固体与液体之间。它们易变形，对温压变化敏感，性质随加工过程而变。食物中的蛋白质、脂质、多糖会自组装成复杂结构(如牛奶中的酪蛋白胶束、肉制品中的胶原网络)。纳米级别的组织决定了产品是奶油状还是具有颗粒感，以及稳定或易碎。
流变学是研究材料流动与变形的科学。在食品中，它定量测量黏度、弹性和稠度等属性。理想的酸奶需足够“坚固”不散架，又足够“流动”便于匙取。流变学数据不仅能预测质地，还能预测消费者的感官感受，是大规模定制化食品设计的关键工具。
食品的最终结构不仅取决于其成分，还取决于分子间作用力、氢键、离子等的相互作用和疏水相互作用。每种力都发挥着特定的作用。
最新研究引人注目的理念之一是分子自组装。这意味着，在特定条件下，分子会自发地聚集在一起，形成诸如胶束、纤维或囊泡之类的有序结构。
软物质物理学已经在实验室之外革新工业流程。最新研究回顾了一些技术，例如精准发酵、利用冷等离子体在不加热食物的情况下改性表面，以及可以塑造植物纤维、模拟肉类结构的高湿度挤压技术等。
研究重点关注人工智能与食品科学的融合。借助机器学习，现在可以根据食品的微观结构、加工条件或成分数据来预测其特性。
这具有直接的应用：无需反复试验即可设计新产品配方、优化酸奶发酵时间或调整3D打印食品的质地。被称为物理信息神经网络的模型将物理方程与实验数据相结合，从而能够更精准地预测现实条件下的食品特性。
此外，机器视觉系统现在能够实时分析食品在烹饪或成型过程中的结构变化，助力自动化和质量控制。
以上这些不仅是食品工业的革命。研究指出，物理学、生物技术和数字化的融合正在改变我们对食物的设计、生产和消费方式。（编译/韩超）",科技 # 食品科学 # 人工智能 # 物理学 # 工业创新,9,1242,21,1263,https://www.cankaoxiaoxi.com/#/detailsPage/tiyujk/7f039cfe16b6431c876563bb147c4a06/1/2025-06-15%2016:24?childrenAlias=undefined
62,"参考消息网6月15日报道 据法新社6月13日报道，英格兰前足球队队长大卫·贝克汉姆因其对体育和慈善事业的贡献于13日被授予爵士头衔。
贝克汉姆共为英格兰队出场115次，此外还曾效力曼联和皇家马德里等世界最知名的足球俱乐部。现在，他的名字前将被冠以“爵士”头衔，他的妻子、前辣妹组合成员维多利亚也将被称为“贝克汉姆夫人”。
贝克汉姆在一份声明中说：“我在伦敦东部长大，我的父母和祖父母都非常爱国，并为自己是英国人而感到自豪，我从没想到会得到如此殊荣。我很幸运能从事这样的工作，很感激这份工作带给我如此大的满足感。”
贝克汉姆的荣誉是他多年来不懈努力的结果。他不仅为足球作出贡献，而且成长为体育、时尚和商业领域的代表人物。
加拿大蒙特利尔大学市场营销学教授玛丽·阿格尼斯·帕尔芒捷说，这一荣誉是英国政府授予的最高荣誉之一，“是一个强大的象征性标志”。
在体育生涯中，贝格汉姆也几经波折。 在1998年世界杯比赛期间，阿根廷队淘汰英格兰队晋级四强，贝克汉姆因在比赛中被红牌罚下而成为“英格兰罪人”。贝克汉姆年轻时还因穿纱笼、化妆和奇异发型被各种小报报道。
据悉，在贝克汉姆助力伦敦赢得2012年奥运会主办权后，当局本来考虑授予他爵士头衔。 但因他涉嫌参与一项避税计划，当局对他的提名有所疑虑。不过，他随后被证明是清白的。（编译/潘晓燕）",体育 # 娱乐 # 社会,8,982,11,993,https://www.cankaoxiaoxi.com/#/detailsPage/tiyujk/3bc391aff1c74f3f89d05078591abf4f/1/2025-06-15%2011:56?childrenAlias=undefined
63,"参考消息网6月13日报道 据英国《经济学人》周刊网站5月23日报道，从冷冰冰的统计数字来看，美国前总统乔·拜登5月18日关于自己被诊断出患有前列腺癌的声明并不那么令人惊讶。
在美国，前列腺癌是仅次于乳腺癌的第二大常见癌症。大约每八名男性中就会有一人在一生中的某个时间点被诊断出患有前列腺癌。与大多数癌症一样，年龄是最大的风险因素，而其他风险因素包括家族史和黑人血统。年轻男性也可能不幸罹患这种癌症。2024年，英国自行车运动员、奥运冠军克里斯·霍伊宣布罹患侵袭性终末期前列腺癌。霍伊体格健壮，当时只有48岁，从表面上看，他的患病风险并不高。
长期以来，此类备受瞩目的病例让医生们对于中年男性是否应该筛查这种疾病争论不休。在霍伊宣布患病之后，英格兰卫生服务部门表示将重新审视其关于是否进行前列腺癌筛查的看法，目前该部门并不建议进行筛查。拜登的办公室表示，这位前总统上一次接受筛查是在2014年。筛查这种常见癌症似乎并不难，但许多医生和医疗组织对这一问题持保留态度。
一个问题是，测量血液中一种名为前列腺特异性抗原（PSA）的化学物质水平这一主要检测方法并不十分可靠。PSA偏高可能是前列腺癌的征兆，但也可能是剧烈运动的迹象。假阳性率——未患癌症但该指数偏高的男性比例——约为75%，假阴性率——检测错误地排除了确实患有前列腺癌的男性——被认为在15%左右。因此，医生会通过活检对PSA偏高者进行复查。
慈善机构英国癌症研究会的纳赛尔·图拉比说，在发现前列腺癌的人中，约有20%的病例需要积极治疗。对于大多数男性来说，前列腺肿瘤要么生长缓慢，要么根本不增长，这意味着他们去世时的确身患癌症，但并非死于癌症。因此，许多医生认为70岁以上的男性一般不应该接受此类检查。而且，治疗有可能带来令人讨厌的永久性副作用，包括尿失禁和肠道问题等。许多医生担心，大规模筛查会导致过度诊断和过度治疗那些不太可能致命的癌症。
英国的一项大型研究发现，患有未扩散前列腺癌的男性，无论他们是接受手术、放射治疗，还是除了对癌症保持警惕之外不采取任何治疗措施，15年存活率都几乎相同，约为97%。这种“警觉地等待”是最保守的方法，但即使这样做也不容易：医生们报告说，许多病人一想到自己患有癌症——即使是不危及生命的癌症——就寝食难安，他们会不顾风险地选择治疗。
所有这些都意味着，不同医生、不同政府对于常规筛查是否明智都存在不同意见。随着技术的进步，这种权衡可能会发生变化。如今，许多PSA偏高的男性在决定是否进行活检之前都会接受磁共振成像扫描。其他科学家希望基因组测序能够帮助评估患者的风险。但是，前列腺癌患者的存活时间很长，这意味着要想知道哪些方法能提高存活率，哪些方法不能提高存活率，获取确凿数据要比临床实践晚很多年。对于中年男性来说，最好的办法（如果不能令人满意的话）可能是询问医生，慎重思考——如果有进一步的行动，请考虑你可能要做出的一些棘手的权衡。（编译/卿松竹）",健康 # 社会 # 科技,8,1699,10,1709,https://www.cankaoxiaoxi.com/#/detailsPage/tiyujk/30008fc1133e4fddb463619874739035/1/2025-06-13%2014:16?childrenAlias=undefined
64,"参考消息网6月13日报道 据合众国际社网站5月28日报道，最新研究表明，中年时期体重仅需减少6.5%，就可能降低晚年患病及过早死亡的风险。
据美国有线电视新闻网报道，研究人员发现，未借助减肥药或手术而减掉约6.5%体重的中年人，在晚年可收获显著的健康益处。以体重180磅（约合81公斤）的人为例，这意味着只需减掉近12磅体重。
芬兰赫尔辛基大学老年医学教授蒂莫·斯特兰德贝里主导了这项研究。他总结说：“尽管不通过手术或药物干预来纠正中年超重问题具有挑战性，但我们的研究结果表明，这一目标是可行的，且可能降低与超重相关的心血管疾病、其他慢性疾病及死亡的长期风险。”
该研究结果5月27日发表在《美国医学会杂志·网络开放》上，其参考数据横跨三个时期，可追溯至20世纪60年代，涵盖近2.3万名成年人。
研究人员根据参与者初始身体质量指数（即BMI，一种基于身高和体重的体脂估算指标），以及体重变化情况（增重、减重或维持）进行分组，随后查阅了病历和死亡档案。
结果显示，减重人群患心脏病、中风、癌症、哮喘及慢性阻塞性肺疾病等肺部疾病的可能性更低，未来35年的全因死亡风险也更低。
值得注意的是，这些人的减重出现在流行减肥药和减重手术问世之前。这意味着，大多数健康改善可能源于饮食和运动习惯的改变。
美国新泽西州拉特格斯大学罗伯特·伍德·约翰逊医学院临床研究员阿尤什·维萨里说：“这项研究意义重大，因为它为体重减轻与心血管疾病及死亡率之间的关联提供了证据，而这一领域此前研究尚不充分。”
但维萨里和斯特兰德贝里均指出，研究中用于追踪体重的BMI是一项不完善的指标——它无法显示脂肪储存部位或肌肉含量，而这些因素也会影响健康风险。
其他研究表明，腹部脂肪和人体器官周围脂肪可能比总体重更关键。
维萨里说：“即便体重变化不大，仍有诸多变量可能影响人体构成的改变。”
尽管这项研究无法证明单纯减重即可带来健康益处，但促使减重的生活方式改变——如更健康的饮食和更多的运动——很可能也发挥了重要作用。
专家建议，每周进行150分钟中等强度运动（如步行或骑行），再加上两天进行肌肉强化活动。
据美国有线电视新闻网报道，富含水果、蔬菜、坚果和橄榄油的地中海饮食模式也有裨益。
维萨里说，谈及健康时，生活方式始终至关重要。这意味着，即便正在服用减肥药，也应努力摄入营养食物并保持活跃。
斯特兰德贝里则指出，社会也需要让人们更易获得健康食品和活动场所。（编译/涂颀）",健康 # 科技 # 社会,9,1489,10,1499,https://www.cankaoxiaoxi.com/#/detailsPage/tiyujk/93012c8bedbd4a4cbae65afd157dfb93/1/2025-06-13%2014:19?childrenAlias=undefined
65,"参考消息网6月17日报道 据伊朗光明新闻网6月13日报道，伊朗最高领袖哈梅内伊6月13日颁布一系列法令，任命伊朗伊斯兰革命卫队和武装部队总参谋部新负责人。
上述任命是在伊朗武装部队总参谋长穆罕默德·巴盖里、伊朗伊斯兰革命卫队总司令侯赛因·萨拉米于当天凌晨在以色列袭击伊朗首都德黑兰时身亡后作出的。
哈梅内伊6月13日发表声明说，等待以色列的必将是“严厉的惩罚”。
武装部队总参谋长赛义德·阿卜杜勒—拉希姆·穆萨维
据伊朗新闻电视台网站6月13日报道，在伊朗武装部队总参谋长穆罕默德·巴盖里在以色列发动的恐怖袭击中牺牲后，伊斯兰革命领袖哈梅内伊任命赛义德·阿卜杜勒—拉希姆·穆萨维为其继任者。
穆萨维自2017年8月起担任伊朗伊斯兰共和国军队总司令，在增强军队实力方面发挥了关键作用。
随后，2019年5月，哈梅内伊任命他为哈塔姆安比亚防空基地指挥官，进一步巩固了他在国家军事战略和行动中的核心作用。
穆萨维1960年出生于伊朗中部的圣城库姆，毕业于伊玛目阿里军官大学，拥有最高国防大学国防研究博士学位，于1979年加入伊朗军队。
20世纪80年代两伊战争期间，穆萨维在炮兵部队前线服役，包括在库尔德斯坦省和胡齐斯坦省。他参与了多项军事行动，是公认的战争老兵。
两伊战争结束后，他于1997年完成高级指挥与参谋课程，随后在最高国防大学获得博士学位。
1999年至2005年，他担任军队联合参谋部参谋长；2008年至2016年，担任军队副总司令；此后在2016年至2017年期间，担任武装部队副参谋长。
在担任上述领导职务之前，穆萨维还曾担任伊玛目阿里军官大学校长，为军事人才培养作出贡献。
他还领导过军队的东北作战基地，负责该地区的战略行动。
此外，他在陆军担任过训练副部长以及规划与项目副部长，在塑造军事战备和战略方面发挥关键作用。
他因在作战领域的专业能力被任命为军队作战部长，后来成为军队战略研究中心主任，从事高级别研究和政策制定工作。
伊斯兰革命领袖在任命书中表示，考虑到穆萨维的卓越贡献和宝贵经验，任命其为巴盖里的继任者。
伊斯兰革命卫队总司令穆罕默德·帕克普尔
据伊朗新闻电视台网站6月13日报道，在侯赛因·萨拉米遭暗杀后，伊斯兰革命领袖哈梅内伊已任命穆罕默德·帕克普尔为伊斯兰革命卫队新任总司令。
帕克普尔1961年出生于伊朗中部城市阿拉克，拥有德黑兰大学地理学硕士学位和塔尔比阿特莫达雷斯大学政治地理学博士学位。
他的专业领域是管理伊朗动荡的边境地区和阐释不对称战争理论。
1979年伊斯兰革命后，帕克普尔加入伊斯兰革命卫队“圣城旅”，随即被部署到库尔德地区打击恐怖组织。
在20世纪80年代的两伊战争期间，他指挥过多支前线部队。
帕克普尔曾在战斗中负伤，以坚韧务实的指挥官形象著称，坚守伊斯兰共和国的意识形态基础。
战后，他在伊斯兰革命卫队内部担任领导职务。2009年，帕克普尔被任命为伊斯兰革命卫队陆军司令，在外国威胁日益严峻的背景下，牵头推动伊朗军事战略的现代化。
帕克普尔在反恐领域的作用尤为显著。2017年“伊斯兰国”组织对伊朗议会和霍梅尼陵发动恐怖袭击时，他指挥精锐部队，彰显了伊斯兰革命卫队在保卫国家中的关键作用。
2021年，欧盟以捕风捉影的借口制裁了帕克普尔，就像多年来制裁许多其他伊斯兰革命卫队指挥官一样。
许多分析人士认为，任命以作战纪律严谨、熟悉地区情况而闻名的帕克普尔是加强伊朗在该地区对抗美国和以色列的决定性步骤。（编译/涂颀、熊文苑）",政治 # 国际,8,2137,6,2143,https://www.cankaoxiaoxi.com/#/detailsPage/wenhualy/5180306edb9345759b9d1fa56a35ed38/1/2025-06-17%2016:46?childrenAlias=undefined
66,"参考消息网6月17日报道 据伊朗光明新闻网6月13日报道，伊朗最高领袖哈梅内伊6月13日颁布一系列法令，任命伊朗伊斯兰革命卫队和武装部队总参谋部新负责人。
上述任命是在伊朗武装部队总参谋长穆罕默德·巴盖里、伊朗伊斯兰革命卫队总司令侯赛因·萨拉米于当天凌晨在以色列袭击伊朗首都德黑兰时身亡后作出的。
哈梅内伊6月13日发表声明说，等待以色列的必将是“严厉的惩罚”。
武装部队总参谋长赛义德·阿卜杜勒—拉希姆·穆萨维
据伊朗新闻电视台网站6月13日报道，在伊朗武装部队总参谋长穆罕默德·巴盖里在以色列发动的恐怖袭击中牺牲后，伊斯兰革命领袖哈梅内伊任命赛义德·阿卜杜勒—拉希姆·穆萨维为其继任者。
穆萨维自2017年8月起担任伊朗伊斯兰共和国军队总司令，在增强军队实力方面发挥了关键作用。
随后，2019年5月，哈梅内伊任命他为哈塔姆安比亚防空基地指挥官，进一步巩固了他在国家军事战略和行动中的核心作用。
穆萨维1960年出生于伊朗中部的圣城库姆，毕业于伊玛目阿里军官大学，拥有最高国防大学国防研究博士学位，于1979年加入伊朗军队。
20世纪80年代两伊战争期间，穆萨维在炮兵部队前线服役，包括在库尔德斯坦省和胡齐斯坦省。他参与了多项军事行动，是公认的战争老兵。
两伊战争结束后，他于1997年完成高级指挥与参谋课程，随后在最高国防大学获得博士学位。
1999年至2005年，他担任军队联合参谋部参谋长；2008年至2016年，担任军队副总司令；此后在2016年至2017年期间，担任武装部队副参谋长。
在担任上述领导职务之前，穆萨维还曾担任伊玛目阿里军官大学校长，为军事人才培养作出贡献。
他还领导过军队的东北作战基地，负责该地区的战略行动。
此外，他在陆军担任过训练副部长以及规划与项目副部长，在塑造军事战备和战略方面发挥关键作用。
他因在作战领域的专业能力被任命为军队作战部长，后来成为军队战略研究中心主任，从事高级别研究和政策制定工作。
伊斯兰革命领袖在任命书中表示，考虑到穆萨维的卓越贡献和宝贵经验，任命其为巴盖里的继任者。
伊斯兰革命卫队总司令穆罕默德·帕克普尔
据伊朗新闻电视台网站6月13日报道，在侯赛因·萨拉米遭暗杀后，伊斯兰革命领袖哈梅内伊已任命穆罕默德·帕克普尔为伊斯兰革命卫队新任总司令。
帕克普尔1961年出生于伊朗中部城市阿拉克，拥有德黑兰大学地理学硕士学位和塔尔比阿特莫达雷斯大学政治地理学博士学位。
他的专业领域是管理伊朗动荡的边境地区和阐释不对称战争理论。
1979年伊斯兰革命后，帕克普尔加入伊斯兰革命卫队“圣城旅”，随即被部署到库尔德地区打击恐怖组织。
在20世纪80年代的两伊战争期间，他指挥过多支前线部队。
帕克普尔曾在战斗中负伤，以坚韧务实的指挥官形象著称，坚守伊斯兰共和国的意识形态基础。
战后，他在伊斯兰革命卫队内部担任领导职务。2009年，帕克普尔被任命为伊斯兰革命卫队陆军司令，在外国威胁日益严峻的背景下，牵头推动伊朗军事战略的现代化。
帕克普尔在反恐领域的作用尤为显著。2017年“伊斯兰国”组织对伊朗议会和霍梅尼陵发动恐怖袭击时，他指挥精锐部队，彰显了伊斯兰革命卫队在保卫国家中的关键作用。
2021年，欧盟以捕风捉影的借口制裁了帕克普尔，就像多年来制裁许多其他伊斯兰革命卫队指挥官一样。
许多分析人士认为，任命以作战纪律严谨、熟悉地区情况而闻名的帕克普尔是加强伊朗在该地区对抗美国和以色列的决定性步骤。（编译/涂颀、熊文苑）",政治 # 国际,8,2137,6,2143,https://www.cankaoxiaoxi.com/#/detailsPage/wenhualy/5180306edb9345759b9d1fa56a35ed38/1/2025-06-17%2016:46?childrenAlias=undefined
67,"参考消息网6月17日报道 澳大利亚“对话”网站近日刊发题为《非洲足球运动员在中国：体育移民趋势背后是什么？》的文章，介绍新书《全球化中国与非洲足球运动》对非洲足球运动员在中超联赛中的表现以及他们在中国经历的探讨。内容编译如下：
一本名为《全球化中国与非洲足球运动》的新书，探讨了足球在中国与非洲关系中的作用，包括文化、政治和经济方面。
美国得克萨斯州州立斯蒂芬·F·奥斯汀大学人体运动学与健康科学教授威克利夫·恩乔罗拉伊·西米尤向“对话”网站聊起该书中他撰写的那一章。这本书以非洲足球移民为研究对象，探讨非洲足球运动员在备受欢迎的中超联赛中的表现，以及他们在中国的经历。
1995年《博斯曼法案》出台后，越来越多非洲男子足球运动员移居海外，参加职业赛事。欧洲法院的这一裁决涉及球员的自由流动。这引发世界各地的体育移民潮，非洲球员是主要受益者。
从历史上看，有抱负的非洲职业足球运动员大多在欧洲寻找机会。然而，中国过去30年经济持续增长，促使该国密切参与全球事务，包括足球运动。中超联赛开始加大吸引外援的投入。对非洲球员而言，它成了一个可行且往往有利可图的选择。这与中国在非洲日益增强的经济影响力相吻合。
非洲球员因其运动能力、速度和技术优势而受到追捧，而且他们的转会费和工资要求往往低于欧洲或南美球员。
2006年至2023年间，有超过141名非洲球员在中超联赛踢球，近六成来自西非。比赛数据显示，许多非洲前锋和中场球员成为关键的组织进攻者。许多人成为联赛的最佳射手。
非洲球员的身体特质常常使他们占据优势，而且许多人很快适应了中国的足球风格。移民球员带来运动才能、国际化的技战术意识，以及使联赛更加精彩刺激的强度。非洲球员正在大大丰富中国的这项运动，就像他们对欧洲足球所做的那样。当然，取决于球员个人、球队战术和联赛不同时期的整体竞技水平，非洲球员的表现会有很大差异。
非洲球员在中超联赛中的经历各不相同。许多球员表示，他们在经济回报和参与高水平职业足球的机会方面获得积极体验。但文化和语言障碍可能带来挑战——非洲球员必须适应中国的饮食和社会风俗；球队内部的交流也需花费时间和精力。
体育运动，尤其是具有全球吸引力和职业化架构的足球运动，是人员跨国流动的重要途径。作为足球运动全球管理机构，国际足联通过各种规章和转会制度促进这种流动。
对许多非洲男性来说，职业足球既能带来经济改善，又能实现社会地位提升。由于经济限制或缺乏发达的职业联赛，这些机会在他们的国家常常受限。因此，他们选择前往像中超联赛这样的联赛，既有推动因素（国内机会有限），也有拉动因素（更多的经济回报以及海外职业经验）。
非洲球员在中超联赛中的存在和表现，有助于提升中国在非洲的软实力和形象。非洲运动员在中国取得成功，可以增进中非人民之间的联系和友谊。
这展示了中国在足球世界中的全球参与者形象，可以将其解读为中国和非洲在经济和政治领域之外相互交流日益加强的迹象。除了球员这一身份，非洲足球运动员还扮演着各自国家和非洲大陆的文化大使角色。
在人文交流层面，非洲球员与他们的中国队友、球迷和社区进行互动，从而增进文化交流与理解。（编译/裘芳）",体育 # 国际 # 社会,8,1727,10,1737,https://www.cankaoxiaoxi.com/#/detailsPage/wenhualy/d360105ba1f74d3bbc37a3b90aa6c815/1/2025-06-17%2015:30?childrenAlias=undefined
68,"《为人父：爱与权力的历史》一书封面
参考消息网6月17日报道 英国《经济学人》周刊网站近日刊发题为《为什么现在是做父亲的最好时代？》的文章，介绍新书《为人父：爱与权力的历史》探讨父亲角色从古至今的演变，展现从权威控制到温情陪伴的转型历程。内容编译如下：
我们的祖先对父亲身份有一些奇怪的想法。在古代雅典，一个婴儿在获得父亲承认前，在法律上还不算是一个人。在命名仪式上，男性家长举起新生儿进行检查，要么将其迎入家族，要么将其弃于荒野，而那意味着九死一生。把婴儿拒之门外的典型原因是畸形，或者仅仅因为这是个女孩。
这一切在今天听起来可能有些恐怖，但其中一些的背后却有着严酷的逻辑。在历史上的大部分时间里，男性没有可靠的方式来判断自己是不是某个孩子的生父，而且在那个几乎人人贫困的世界中，大多数人都不愿冒险把粮食浪费在别人的后代身上。因此，许多男性坚持对女性生育实施高压控制，禁止他们的妻子和女儿与其他男性交往，以及（在古代雅典）宣称有权杀死任何他们不愿承认的孩子。
美国学者奥古斯丁·塞奇威克在其著作《为人父：爱与权力的历史》一书中，讲述了人们对父亲的看法如何随着时间推移而改变。令人震惊的是，人们竟然相信过如此五花八门的谬论。
圣奥古斯丁是一个颇具影响力的早期基督教教徒。他观察到自己幼子（后来夭折）的自私行为后，提出“原罪”的概念：婴儿的恶继承自父亲，这是通过性行为本身传递的。父亲的恶又继承自他的父亲，以此类推，一直追溯到亚当。这成为一条教义，并被当作为婴儿洗礼的理由。
另一个常见的主题是残忍。据传，马丁·路德曾说过“宁要子亡，不要子逆”。1662年，弗吉尼亚殖民政府废除了儿子继承父亲地位这项古老的英国传统，规定子女的社会地位应随母亲。这听起来像是早期女权主义的突破，实则不然。这只是为了方便男性种植园主让他们的女性奴隶怀孕，因为他们知道女性奴隶的后代也是奴隶。
在现代，有两大变化影响了人们对为人父的看法。其一，由于DNA检测的出现，“人类历史上首次可以毫无疑问地确定父子关系”。其二，父亲照顾孩子的时间比以往任何时候都要多。由于可靠的避孕技术、教育的普及和女性主义的（部分）胜利，女性的收入比过去更高。她们不再需要靠丈夫的工资来养活孩子，因而可以更加挑剔地选择结婚对象（或是否结婚）。这反过来又让她们可以要求在家庭内部实现更公平的劳动分工，即使洗衣机和外卖软件已经为照顾孩子节省出了时间。尽管绝对平等尚未实现，但现代社会的大多数父亲已经发现：父母共同抚养孩子回报颇丰。
现在或许是为人父的最佳时机，至少在富裕国家是如此。很多雇主会提供充裕的陪产假。在欧洲大部分地区，陪产假是强制性的。如今，美国的父亲们用于照顾子女的时间是20世纪60年代的三倍。
认为读睡前故事缺乏男子气概的观念现在已彻底过时：与女性相比，男性可能更希望多陪伴自家的熊孩子。与老一辈信奉不打不成器不同，今天的父亲更加温柔，更愿意聊天。孩子们受益于父亲更多的陪伴，这尤其是因为母亲和父亲常常以互补的方式照料子女。
流行文化已经接受了这种家庭等级观念弱化的趋势。如今，没有哪家电视台会制作像《老爸最知道》这样的节目，单看标题就知道这部20世纪50年代的美国情景喜剧讲述的是什么内容。如果说有什么不同的话，那就是现在的趋势是把父亲描绘成笨蛋。在卡通片《恶搞之家》中，父亲彼得·格里芬太笨了，以至于在海洋世界里因为嫉妒而打了一头用嘴碰他妻子的虎鲸。
然而，更大程度的平等在带来好处的同时也带来一个大问题——并非所有男性都能很好地适应这个新世界。在美国，受过大学教育的男性花在孩子身上的时间更多了。而受教育程度较低的男性花在孩子身上的时间却比20年前略少，他们也更有可能与孩子分开生活，甚至根本见不到面。这在育儿上造成阶级分化。中上层阶级的孩子一直享有经济优势，他们的家庭环境也更加稳定并且催人上进。与此同时，许多工薪阶层的男性完全失去为人父的乐趣：既然女性有权变得更挑剔，那就会有更多男性打光棍。许多人对此深恶痛绝，这在发达国家许多地方助长了男性的怨愤政治。
令人失望的是，塞奇威克未能抓住这些趋势。相反，他的结论带有个人色彩。当他问自己的小儿子“父亲应该是什么样的人”时，小男孩回答说，父亲应该“风趣幽默，善于拥抱”。若论为父之道，此言无懈可击。（编译/卿松竹）",社会 # 教育 # 健康 # 家庭,8,2394,15,2409,https://www.cankaoxiaoxi.com/#/detailsPage/wenhualy/a87d99b217e64f349f7747e1fc0d76f1/1/2025-06-17%2015:30?childrenAlias=undefined
69,"参考消息网6月17日报道 美国《时代》周刊网站6月7日刊登题为《人工智能无法取代人类的教育，除非我们拱手相让》的文章，作者为美国普渡大学人类学副教授埃里克·奥塔罗拉·卡斯蒂略。全文编译如下：
看到毕业典礼上朝气蓬勃的毕业生对未来满怀憧憬，我脑海中隐隐浮现出一个问题：人工智能会让教育变得毫无意义吗？
事实上，人工智能对人类学习思考有益还是有害，取决于一个关键决定：我们指望它做什么？
人工智能需要人类的判断，我们不仅要监督输出，还要嵌入科学的栅栏。
近来，物理学家艾伦·索卡尔将人工智能聊天机器人比作口语考试成绩良好的学生。他在宾夕法尼亚大学的一次活动上说：“当它们(人工智能聊天机器人)知道答案时，它们会告诉你。当它们没有答案时，它们真的很擅长胡扯。”根据索卡尔的说法，除非用户对某个既定话题非常了解，否则可能无法察觉到聊天机器人在“胡说八道”。在我看来，这完美诠释了人工智能所谓的“知识”。它可以通过预测词串来模仿人类的理解能力，却缺乏相关的概念基础。
当教师担心人工智能导师可能会阻碍学生的批判性思维，或是医生担心算法误诊时，他们都发现了人工智能的同一个缺陷——即机器学习虽然在模式识别方面表现出色，却缺乏人类日积月累的系统性经验以及科学方法所产生的深度认知。
这就是人工智能领域不断发展的趋势所提供的前进方向。它专注于将人类知识直接嵌入到机器的学习方式中。物理信息神经网络(PINN)和机械神经网络(MINN)就是例子。这些名字或许听起来很专业，但理念却很简单：当人工智能遵循规则时，它会变得更好，无论是物理、生物还是社会学定律。这就意味着，人类不仅需要去使用知识，还要去创造知识。人工智能只有向人类学习才能有出色表现。
我在使用MINN时就意识到了这一点。我们没有让算法基于之前的数据进行猜测，而是进行编程，使之按照既定科学原理做判断。以印第安纳州当地家庭薰衣草农场为例。对于这种生意，开花时间就是一切。采摘过早或过晚都会影响精油的效力、质量和最终利润。MINN会从植物生物学出发，利用光、热、霜和水与开花相关的方程式，及时做出具有经济学意义的预测。只有当人工智能深入了解物理、化学和生物领域时才能给出行之有效的建议，而这些知识均来源于人类科学。
结论简单明了：人类仍然至关重要。随着人工智能越来越精密，人类角色并没有消失，而是出现了转变。当算法产生一些奇怪、片面或错误的结果时，人类需要及时提出质疑。这不仅是人工智能的弱点，也是人类最大的优势。这意味着人类的知识仍需不断扩充，引导并掌控技术，确保人工智能按照人类的意愿做事，为人类提供帮助。
人工智能不会降低教育的重要性，也不会取代人类。然而，如果我们忘记如何独立思考，忘记科学和深层理解的重要性，那么有朝一日人类或许会被取代。（编译/文怡）",科技 # 教育 # 社会,9,1523,10,1533,https://www.cankaoxiaoxi.com/#/detailsPage/wenhualy/9ef038078d094381a47f8e059cd92fc7/1/2025-06-17%2014:36?childrenAlias=undefined
70,"参考消息网6月17日报道 西班牙《国家报》网站近日刊登题为《“积读”现象：我们是如何对只囤不读的书习以为常的》的文章，作者为豪尔赫·马索·阿劳索。内容编译如下：
一本、两本、三本……直到超过30本。这是安德烈娅·阿拉贡家中书架上未读书籍的数量。这种奇怪的收藏对这个书迷来说似乎还不够。不管是冲动消费还是有计划地购买，她将继续在书店买书。同她一样，许多人都存放着甚至没有翻开第一页的书。这种现象在19世纪的日本已经有了一个术语：“积读”。换句话说，就是买书、囤书，虽有心阅读，却没有真正读过。
“我喜欢看它们叠在一起。一本叠着一本，一本挨着一本，共处一个空间。不是说我会感到快乐，但知道我有这样一个收藏，内心确实有点激动。”阿拉贡自豪地说。她去书店时往往会买回新书：“我有时候走进书店，看上一本书的封面或内容简介，然后说‘我要了’。”TikTok平台网红比阿特丽斯·马林也有这样的经历，她说：“如今，有那么多新书和新事物问世，你去购物，发现有三本吸引你的书，你就会买下来。不过，书不会过期，文学也不会。”
根据加泰罗尼亚开放大学(UOC)心理学与教育科学专业顾问蒙特塞拉特·拉卡列的说法，有两个因素可以解释这种现象。“第一个因素出现在人们采取某种行为时。人们在买书时会感到激动，一种仿佛已经读过或者已经掌握书中知识的感觉。这种体验是非常愉悦的。”另一个是拖延症。“有时，我们认为拖延是由于不感兴趣或缺乏动力，但事实不一定如此。有些人必须在理想环境下阅读，比如周围必须非常宁静，但找不到合适的时机，最终在行为上造成拖延。本质上，是一天天推迟，最终发现永远没有时机去完成这个行为。”
为什么我们会把书放着不读，尽管最初的想法是要读它们？拉卡列解释说：“我们会把注意力或解决方案放在不需要的地方，然后会变成一种恶性循环。会有人感到内疚吗？是的。但奇怪的是，这个人会再去买另一本书。”这名专家说：“当我们的想法和行为不一致时，人们可能会认为，要做的是改变行为，使之保持一致。但事实并非如此。我们称这种现象为认知失调。大多数人所做的是改变想法，并形成一种与行为相一致的叙述。”（编译/苏佳维）",社会 # 心理 # 阅读习惯,8,1331,12,1343,https://www.cankaoxiaoxi.com/#/detailsPage/wenhualy/1b01f7ef067240e09dd3dd6ed20f00d1/1/2025-06-17%2014:36?childrenAlias=undefined
71,"参考消息网6月17日报道 日本《朝日新闻》6月8日刊登题为《一场深沉而炽烈的邂逅》的文章，作者为私人图书馆主理人幅允孝。全文编译如下：
由于母亲是近现代文学爱好者，我家堆满了书。比如白桦派作家武者小路实笃、志贺直哉、有岛武郎等人的作品。其中一些尽管母亲告诉我先不要读，但当时还在读小学高年级的我仍充满好奇。川端康成的《片腕》曾让我产生强烈的震撼。我现在还能记得那种不依靠视觉只通过文字就能营造出的香艳场景是多么令人兴奋。
因为工作的原因，人们总是认为我读书很多，是个专家，但事实并非如此。我不想把读书变成不得已而为之，也不会硬要和别人分享我的阅读体验。我的态度很简单，“一个人安安静静地读自己想读的书”。从3岁到18岁，我一直坚持游泳，游泳是我在“向外释放能量”，而阅读是我在“审视内心”，所以我觉得自己很好地实现了内外平衡。而且在读书方面我属于“杂食动物”，没有一定之规。
有很多书让我觉得读起来“很难”。比如我在15岁之后开始读的马尔克斯的《百年孤独》。故事很有趣，但出场人物都是亲戚，名字很相似，很容易产生混乱。我想这大概就是作者的意图吧。当时并没有布恩地亚家族的现成家谱，所以只能一边对照我自己绘制的家谱一遍又一遍反复阅读。
当时的我认为，阅读总要搞明白“一些东西”，每读完一本书我的知识就会加深。然而，我与《百年孤独》的相遇是一次宝贵的经验，这让我懂得了“即使你没有完全理解，阅读也依然有趣”。如果你对一本看似艰涩的书感兴趣，不妨拿起它尝试读下去，记住它难在哪儿以及为什么让你感觉读不下去。不同的书籍或事件中可能隐藏着相互交织的线索，几年后再读同一本书你或许就能理解它了。
我想对年轻一代说，“不必着急”。“不想失败”已经成为我们这个时代的常见病，但请对自己身上的“野性”保持信心。既然读书是一件很私人的事情，那么在选择读什么书的时候，也不要被周围的人所左右，完全可以凭直觉。
鉴于我们不可能在重读一本书时保持和第一遍阅读时完全相同的心态，所以我希望大家能够享受这独一无二的初遇体验。此外，阅读看似安静，实则蕴含着惊人的力量。如果能够将阅读视为作者与读者之间一对一的心灵交流，努力感受字里行间的留白和余韵，积极探索作者内心深处的想法，无疑是乐事一桩。
似乎越来越多的人开始在观看电影时选择快进，或者在了解故事梗概后再读原著。我理解繁忙的工作让我们越来越缺少闲暇时光，但我认为，内心世界深不见底，只有细心研读才能抵达。当你沉下心来深入其中，原本未曾察觉到的自我意识就会浮现，而这将成为我们人生新的起点。
随着生成式人工智能深度学习的进步，一个无需考虑背景或因果关系即可寻求短期答案的世界正在被创造出来。在这样的过程中，我之所以为我，你之所以是你，难道不是来自那沉睡在我们内心深处的扭曲、偏颇但又炽热的某些东西吗？在这个系统、技术凌驾于人类之上的世界中，书籍将成为反抗的工具，透过书籍我们仿佛体会到人类内心深处的温度，让我们重新审视人何以为人。（编译/刘林）",文化 # 阅读 # 书籍 # 个人成长 # 人文,8,1738,17,1755,https://www.cankaoxiaoxi.com/#/detailsPage/wenhualy/3aaa0863510d4dacaf28f0b447e3b51e/1/2025-06-17%2014:42?childrenAlias=undefined
